KFZ_R1,KFZ_R2,KFZ_TOTAL,Datum,Wotag,Stunde
36,62,98,190101,2,1
109,112,221,190101,2,2
97,60,157,190101,2,3
60,44,104,190101,2,4
44,33,77,190101,2,5
46,43,89,190101,2,6
39,41,80,190101,2,7
26,35,61,190101,2,8
38,19,57,190101,2,9
47,53,100,190101,2,10
112,111,223,190101,2,11
194,180,374,190101,2,12
306,234,540,190101,2,13
274,272,546,190101,2,14
303,315,618,190101,2,15
249,285,534,190101,2,16
267,278,545,190101,2,17
204,236,440,190101,2,18
124,149,273,190101,2,19
101,103,204,190101,2,20
83,75,158,190101,2,21
31,44,75,190101,2,22
29,40,69,190101,2,23
14,16,30,190101,2,24
11,14,25,190102,3,1
4,5,9,190102,3,2
4,4,8,190102,3,3
11,8,19,190102,3,4
30,40,70,190102,3,5
137,76,213,190102,3,6
266,198,464,190102,3,7
394,252,646,190102,3,8
359,277,636,190102,3,9
454,340,794,190102,3,10
495,431,926,190102,3,11
540,492,1032,190102,3,12
514,493,1007,190102,3,13
464,485,949,190102,3,14
522,511,1033,190102,3,15
495,529,1024,190102,3,16
485,578,1063,190102,3,17
360,486,846,190102,3,18
275,323,598,190102,3,19
165,212,377,190102,3,20
128,151,279,190102,3,21
68,80,148,190102,3,22
57,73,130,190102,3,23
30,37,67,190102,3,24
19,16,35,190103,4,1
13,12,25,190103,4,2
7,15,22,190103,4,3
9,9,18,190103,4,4
36,31,67,190103,4,5
120,80,200,190103,4,6
255,174,429,190103,4,7
438,274,712,190103,4,8
359,253,612,190103,4,9
379,309,688,190103,4,10
442,378,820,190103,4,11
482,432,914,190103,4,12
453,517,970,190103,4,13
486,528,1014,190103,4,14
511,500,1011,190103,4,15
483,587,1070,190103,4,16
515,583,1098,190103,4,17
384,496,880,190103,4,18
280,394,674,190103,4,19
152,237,389,190103,4,20
130,132,262,190103,4,21
87,111,198,190103,4,22
49,65,114,190103,4,23
22,42,64,190103,4,24
18,24,42,190104,5,1
13,10,23,190104,5,2
4,10,14,190104,5,3
10,13,23,190104,5,4
42,33,75,190104,5,5
112,86,198,190104,5,6
273,177,450,190104,5,7
395,269,664,190104,5,8
336,271,607,190104,5,9
408,323,731,190104,5,10
420,401,821,190104,5,11
481,441,922,190104,5,12
494,475,969,190104,5,13
499,446,945,190104,5,14
466,511,977,190104,5,15
434,496,930,190104,5,16
422,467,889,190104,5,17
342,400,742,190104,5,18
299,333,632,190104,5,19
188,178,366,190104,5,20
133,151,284,190104,5,21
103,123,226,190104,5,22
59,100,159,190104,5,23
36,55,91,190104,5,24
23,39,62,190105,6,1
27,37,64,190105,6,2
19,23,42,190105,6,3
14,10,24,190105,6,4
17,15,32,190105,6,5
57,36,93,190105,6,6
63,42,105,190105,6,7
96,75,171,190105,6,8
178,126,304,190105,6,9
299,226,525,190105,6,10
429,367,796,190105,6,11
468,392,860,190105,6,12
428,400,828,190105,6,13
472,454,926,190105,6,14
395,435,830,190105,6,15
364,363,727,190105,6,16
345,379,724,190105,6,17
304,346,650,190105,6,18
240,271,511,190105,6,19
148,223,371,190105,6,20
128,150,278,190105,6,21
88,112,200,190105,6,22
65,79,144,190105,6,23
94,91,185,190105,6,24
33,34,67,190106,7,1
47,31,78,190106,7,2
20,25,45,190106,7,3
17,15,32,190106,7,4
17,14,31,190106,7,5
40,32,72,190106,7,6
33,31,64,190106,7,7
46,37,83,190106,7,8
96,52,148,190106,7,9
184,126,310,190106,7,10
265,219,484,190106,7,11
301,268,569,190106,7,12
376,307,683,190106,7,13
389,370,759,190106,7,14
383,403,786,190106,7,15
305,380,685,190106,7,16
282,379,661,190106,7,17
260,312,572,190106,7,18
165,203,368,190106,7,19
125,157,282,190106,7,20
86,98,184,190106,7,21
44,80,124,190106,7,22
51,51,102,190106,7,23
17,28,45,190106,7,24
9,18,27,190107,1,1
9,10,19,190107,1,2
3,7,10,190107,1,3
17,15,32,190107,1,4
37,28,65,190107,1,5
201,159,360,190107,1,6
489,408,897,190107,1,7
783,482,1265,190107,1,8
546,346,892,190107,1,9
478,380,858,190107,1,10
444,473,917,190107,1,11
483,505,988,190107,1,12
474,527,1001,190107,1,13
462,533,995,190107,1,14
507,488,995,190107,1,15
538,632,1170,190107,1,16
650,723,1373,190107,1,17
492,557,1049,190107,1,18
315,464,779,190107,1,19
221,262,483,190107,1,20
126,149,275,190107,1,21
133,125,258,190107,1,22
36,85,121,190107,1,23
22,29,51,190107,1,24
6,20,26,190108,2,1
8,7,15,190108,2,2
8,6,14,190108,2,3
11,10,21,190108,2,4
33,26,59,190108,2,5
199,126,325,190108,2,6
501,396,897,190108,2,7
816,517,1333,190108,2,8
539,397,936,190108,2,9
464,357,821,190108,2,10
454,444,898,190108,2,11
437,450,887,190108,2,12
450,497,947,190108,2,13
458,528,986,190108,2,14
479,548,1027,190108,2,15
482,627,1109,190108,2,16
694,731,1425,190108,2,17
461,606,1067,190108,2,18
314,417,731,190108,2,19
235,260,495,190108,2,20
122,171,293,190108,2,21
71,129,200,190108,2,22
59,67,126,190108,2,23
25,25,50,190108,2,24
9,22,31,190109,3,1
10,6,16,190109,3,2
3,2,5,190109,3,3
12,13,25,190109,3,4
43,32,75,190109,3,5
204,139,343,190109,3,6
516,381,897,190109,3,7
800,505,1305,190109,3,8
533,378,911,190109,3,9
493,385,878,190109,3,10
427,408,835,190109,3,11
429,465,894,190109,3,12
492,517,1009,190109,3,13
447,542,989,190109,3,14
502,551,1053,190109,3,15
520,643,1163,190109,3,16
646,700,1346,190109,3,17
459,571,1030,190109,3,18
314,382,696,190109,3,19
202,237,439,190109,3,20
138,176,314,190109,3,21
103,122,225,190109,3,22
78,86,164,190109,3,23
26,40,66,190109,3,24
13,17,30,190110,4,1
13,15,28,190110,4,2
6,4,10,190110,4,3
12,16,28,190110,4,4
36,28,64,190110,4,5
193,138,331,190110,4,6
492,392,884,190110,4,7
824,502,1326,190110,4,8
527,389,916,190110,4,9
484,393,877,190110,4,10
446,464,910,190110,4,11
463,464,927,190110,4,12
431,496,927,190110,4,13
501,539,1040,190110,4,14
508,522,1030,190110,4,15
549,648,1197,190110,4,16
645,741,1386,190110,4,17
514,583,1097,190110,4,18
293,477,770,190110,4,19
211,281,492,190110,4,20
149,163,312,190110,4,21
99,114,213,190110,4,22
62,78,140,190110,4,23
33,38,71,190110,4,24
7,19,26,190111,5,1
6,8,14,190111,5,2
9,9,18,190111,5,3
10,10,20,190111,5,4
34,31,65,190111,5,5
189,128,317,190111,5,6
473,372,845,190111,5,7
757,519,1276,190111,5,8
457,395,852,190111,5,9
480,363,843,190111,5,10
496,442,938,190111,5,11
559,563,1122,190111,5,12
631,638,1269,190111,5,13
591,667,1258,190111,5,14
544,670,1214,190111,5,15
507,597,1104,190111,5,16
528,590,1118,190111,5,17
443,474,917,190111,5,18
300,383,683,190111,5,19
214,230,444,190111,5,20
148,154,302,190111,5,21
121,127,248,190111,5,22
69,113,182,190111,5,23
55,74,129,190111,5,24
29,29,58,190112,6,1
16,29,45,190112,6,2
14,16,30,190112,6,3
10,15,25,190112,6,4
12,14,26,190112,6,5
62,48,110,190112,6,6
57,58,115,190112,6,7
122,90,212,190112,6,8
220,152,372,190112,6,9
319,250,569,190112,6,10
423,388,811,190112,6,11
418,500,918,190112,6,12
446,447,893,190112,6,13
389,400,789,190112,6,14
344,414,758,190112,6,15
341,408,749,190112,6,16
306,348,654,190112,6,17
331,348,679,190112,6,18
238,279,517,190112,6,19
179,171,350,190112,6,20
168,132,300,190112,6,21
88,108,196,190112,6,22
69,100,169,190112,6,23
40,78,118,190112,6,24
48,46,94,190113,7,1
25,43,68,190113,7,2
20,26,46,190113,7,3
15,21,36,190113,7,4
17,15,32,190113,7,5
37,40,77,190113,7,6
34,30,64,190113,7,7
39,43,82,190113,7,8
71,48,119,190113,7,9
176,170,346,190113,7,10
223,252,475,190113,7,11
256,268,524,190113,7,12
334,295,629,190113,7,13
342,330,672,190113,7,14
346,374,720,190113,7,15
313,364,677,190113,7,16
293,290,583,190113,7,17
306,305,611,190113,7,18
197,206,403,190113,7,19
145,194,339,190113,7,20
110,149,259,190113,7,21
55,74,129,190113,7,22
40,43,83,190113,7,23
15,27,42,190113,7,24
9,24,33,190114,1,1
5,9,14,190114,1,2
7,10,17,190114,1,3
7,12,19,190114,1,4
44,40,84,190114,1,5
211,176,387,190114,1,6
547,388,935,190114,1,7
822,570,1392,190114,1,8
564,380,944,190114,1,9
473,434,907,190114,1,10
472,446,918,190114,1,11
452,488,940,190114,1,12
511,526,1037,190114,1,13
485,538,1023,190114,1,14
554,515,1069,190114,1,15
538,625,1163,190114,1,16
620,790,1410,190114,1,17
466,610,1076,190114,1,18
327,470,797,190114,1,19
254,275,529,190114,1,20
136,142,278,190114,1,21
90,110,200,190114,1,22
49,99,148,190114,1,23
17,35,52,190114,1,24
9,12,21,190115,2,1
8,8,16,190115,2,2
6,8,14,190115,2,3
11,12,23,190115,2,4
37,41,78,190115,2,5
204,137,341,190115,2,6
539,380,919,190115,2,7
814,530,1344,190115,2,8
551,413,964,190115,2,9
495,391,886,190115,2,10
478,478,956,190115,2,11
452,485,937,190115,2,12
435,501,936,190115,2,13
453,560,1013,190115,2,14
503,505,1008,190115,2,15
510,676,1186,190115,2,16
646,725,1371,190115,2,17
479,585,1064,190115,2,18
330,453,783,190115,2,19
225,293,518,190115,2,20
139,148,287,190115,2,21
95,116,211,190115,2,22
58,73,131,190115,2,23
23,33,56,190115,2,24
17,11,28,190116,3,1
11,7,18,190116,3,2
4,7,11,190116,3,3
13,9,22,190116,3,4
40,33,73,190116,3,5
203,135,338,190116,3,6
513,364,877,190116,3,7
780,537,1317,190116,3,8
516,391,907,190116,3,9
462,370,832,190116,3,10
486,430,916,190116,3,11
440,446,886,190116,3,12
476,518,994,190116,3,13
454,569,1023,190116,3,14
483,542,1025,190116,3,15
523,621,1144,190116,3,16
612,702,1314,190116,3,17
441,560,1001,190116,3,18
337,423,760,190116,3,19
197,275,472,190116,3,20
147,180,327,190116,3,21
95,129,224,190116,3,22
68,71,139,190116,3,23
32,34,66,190116,3,24
15,23,38,190117,4,1
8,10,18,190117,4,2
8,12,20,190117,4,3
12,12,24,190117,4,4
37,35,72,190117,4,5
203,137,340,190117,4,6
498,387,885,190117,4,7
820,520,1340,190117,4,8
561,393,954,190117,4,9
493,434,927,190117,4,10
457,469,926,190117,4,11
432,468,900,190117,4,12
470,540,1010,190117,4,13
486,495,981,190117,4,14
457,522,979,190117,4,15
587,646,1233,190117,4,16
669,699,1368,190117,4,17
486,592,1078,190117,4,18
315,481,796,190117,4,19
235,288,523,190117,4,20
124,174,298,190117,4,21
102,120,222,190117,4,22
75,104,179,190117,4,23
44,38,82,190117,4,24
12,21,33,190118,5,1
6,13,19,190118,5,2
13,10,23,190118,5,3
14,27,41,190118,5,4
42,37,79,190118,5,5
192,138,330,190118,5,6
468,349,817,190118,5,7
800,515,1315,190118,5,8
493,413,906,190118,5,9
473,407,880,190118,5,10
455,459,914,190118,5,11
546,521,1067,190118,5,12
595,677,1272,190118,5,13
540,639,1179,190118,5,14
631,639,1270,190118,5,15
623,612,1235,190118,5,16
589,551,1140,190118,5,17
459,496,955,190118,5,18
348,415,763,190118,5,19
237,257,494,190118,5,20
140,165,305,190118,5,21
98,115,213,190118,5,22
90,112,202,190118,5,23
58,113,171,190118,5,24
34,67,101,190119,6,1
26,23,49,190119,6,2
15,30,45,190119,6,3
13,15,28,190119,6,4
24,19,43,190119,6,5
60,39,99,190119,6,6
66,54,120,190119,6,7
111,86,197,190119,6,8
194,157,351,190119,6,9
378,261,639,190119,6,10
417,362,779,190119,6,11
486,420,906,190119,6,12
474,421,895,190119,6,13
398,442,840,190119,6,14
387,465,852,190119,6,15
314,413,727,190119,6,16
310,374,684,190119,6,17
303,359,662,190119,6,18
249,273,522,190119,6,19
176,208,384,190119,6,20
113,149,262,190119,6,21
88,105,193,190119,6,22
74,95,169,190119,6,23
61,78,139,190119,6,24
54,58,112,190120,7,1
49,35,84,190120,7,2
28,28,56,190120,7,3
17,25,42,190120,7,4
20,32,52,190120,7,5
48,33,81,190120,7,6
38,45,83,190120,7,7
36,53,89,190120,7,8
75,80,155,190120,7,9
170,143,313,190120,7,10
223,196,419,190120,7,11
316,300,616,190120,7,12
355,290,645,190120,7,13
396,396,792,190120,7,14
424,427,851,190120,7,15
363,407,770,190120,7,16
342,387,729,190120,7,17
288,316,604,190120,7,18
197,241,438,190120,7,19
152,170,322,190120,7,20
112,134,246,190120,7,21
57,85,142,190120,7,22
56,54,110,190120,7,23
24,26,50,190120,7,24
3,18,21,190121,1,1
9,5,14,190121,1,2
9,8,17,190121,1,3
13,12,25,190121,1,4
41,35,76,190121,1,5
207,160,367,190121,1,6
495,389,884,190121,1,7
826,525,1351,190121,1,8
548,429,977,190121,1,9
454,404,858,190121,1,10
454,403,857,190121,1,11
407,489,896,190121,1,12
483,524,1007,190121,1,13
484,502,986,190121,1,14
466,524,990,190121,1,15
548,619,1167,190121,1,16
634,669,1303,190121,1,17
470,604,1074,190121,1,18
332,464,796,190121,1,19
213,276,489,190121,1,20
123,155,278,190121,1,21
95,119,214,190121,1,22
35,62,97,190121,1,23
22,18,40,190121,1,24
9,14,23,190122,2,1
7,13,20,190122,2,2
14,15,29,190122,2,3
15,24,39,190122,2,4
36,45,81,190122,2,5
207,140,347,190122,2,6
496,386,882,190122,2,7
830,537,1367,190122,2,8
555,387,942,190122,2,9
440,392,832,190122,2,10
417,407,824,190122,2,11
485,469,954,190122,2,12
478,505,983,190122,2,13
447,570,1017,190122,2,14
507,548,1055,190122,2,15
549,619,1168,190122,2,16
629,768,1397,190122,2,17
455,614,1069,190122,2,18
341,454,795,190122,2,19
251,267,518,190122,2,20
146,179,325,190122,2,21
100,144,244,190122,2,22
52,79,131,190122,2,23
24,30,54,190122,2,24
9,18,27,190123,3,1
7,20,27,190123,3,2
10,7,17,190123,3,3
12,11,23,190123,3,4
34,39,73,190123,3,5
212,144,356,190123,3,6
516,374,890,190123,3,7
809,544,1353,190123,3,8
516,411,927,190123,3,9
491,371,862,190123,3,10
471,445,916,190123,3,11
446,468,914,190123,3,12
488,516,1004,190123,3,13
473,560,1033,190123,3,14
504,549,1053,190123,3,15
532,655,1187,190123,3,16
600,735,1335,190123,3,17
481,602,1083,190123,3,18
376,427,803,190123,3,19
216,228,444,190123,3,20
141,138,279,190123,3,21
74,136,210,190123,3,22
70,74,144,190123,3,23
23,33,56,190123,3,24
16,23,39,190124,4,1
10,18,28,190124,4,2
7,6,13,190124,4,3
12,15,27,190124,4,4
31,27,58,190124,4,5
189,140,329,190124,4,6
500,368,868,190124,4,7
824,499,1323,190124,4,8
550,386,936,190124,4,9
477,429,906,190124,4,10
422,418,840,190124,4,11
475,486,961,190124,4,12
474,539,1013,190124,4,13
482,562,1044,190124,4,14
467,520,987,190124,4,15
521,642,1163,190124,4,16
685,757,1442,190124,4,17
480,601,1081,190124,4,18
331,436,767,190124,4,19
234,310,544,190124,4,20
156,204,360,190124,4,21
119,116,235,190124,4,22
65,86,151,190124,4,23
30,36,66,190124,4,24
11,21,32,190125,5,1
13,18,31,190125,5,2
5,11,16,190125,5,3
14,8,22,190125,5,4
38,32,70,190125,5,5
189,139,328,190125,5,6
456,342,798,190125,5,7
768,481,1249,190125,5,8
524,389,913,190125,5,9
462,406,868,190125,5,10
494,462,956,190125,5,11
542,608,1150,190125,5,12
597,687,1284,190125,5,13
528,657,1185,190125,5,14
534,610,1144,190125,5,15
514,585,1099,190125,5,16
472,573,1045,190125,5,17
398,461,859,190125,5,18
342,398,740,190125,5,19
271,233,504,190125,5,20
151,179,330,190125,5,21
83,117,200,190125,5,22
98,109,207,190125,5,23
49,96,145,190125,5,24
39,66,105,190126,6,1
25,30,55,190126,6,2
12,20,32,190126,6,3
20,19,39,190126,6,4
24,37,61,190126,6,5
64,52,116,190126,6,6
57,58,115,190126,6,7
122,99,221,190126,6,8
199,144,343,190126,6,9
289,224,513,190126,6,10
413,336,749,190126,6,11
433,400,833,190126,6,12
416,421,837,190126,6,13
377,447,824,190126,6,14
365,432,797,190126,6,15
300,360,660,190126,6,16
322,346,668,190126,6,17
306,300,606,190126,6,18
219,248,467,190126,6,19
151,203,354,190126,6,20
102,146,248,190126,6,21
74,103,177,190126,6,22
99,70,169,190126,6,23
63,88,151,190126,6,24
61,35,96,190127,7,1
50,32,82,190127,7,2
22,24,46,190127,7,3
27,25,52,190127,7,4
19,20,39,190127,7,5
45,40,85,190127,7,6
35,43,78,190127,7,7
41,38,79,190127,7,8
99,64,163,190127,7,9
155,155,310,190127,7,10
198,217,415,190127,7,11
265,271,536,190127,7,12
307,308,615,190127,7,13
304,298,602,190127,7,14
299,304,603,190127,7,15
239,292,531,190127,7,16
287,298,585,190127,7,17
292,283,575,190127,7,18
182,216,398,190127,7,19
149,150,299,190127,7,20
103,110,213,190127,7,21
71,81,152,190127,7,22
39,63,102,190127,7,23
25,37,62,190127,7,24
12,22,34,190128,1,1
9,13,22,190128,1,2
6,9,15,190128,1,3
15,17,32,190128,1,4
38,42,80,190128,1,5
211,141,352,190128,1,6
491,352,843,190128,1,7
818,529,1347,190128,1,8
509,395,904,190128,1,9
481,415,896,190128,1,10
469,444,913,190128,1,11
472,471,943,190128,1,12
492,520,1012,190128,1,13
505,507,1012,190128,1,14
456,473,929,190128,1,15
559,670,1229,190128,1,16
592,720,1312,190128,1,17
428,556,984,190128,1,18
302,459,761,190128,1,19
206,249,455,190128,1,20
131,140,271,190128,1,21
90,113,203,190128,1,22
60,69,129,190128,1,23
22,26,48,190128,1,24
15,16,31,190129,2,1
10,12,22,190129,2,2
8,8,16,190129,2,3
13,19,32,190129,2,4
42,39,81,190129,2,5
190,135,325,190129,2,6
513,367,880,190129,2,7
816,484,1300,190129,2,8
492,395,887,190129,2,9
483,393,876,190129,2,10
428,434,862,190129,2,11
456,442,898,190129,2,12
467,475,942,190129,2,13
477,555,1032,190129,2,14
488,508,996,190129,2,15
524,657,1181,190129,2,16
624,720,1344,190129,2,17
484,632,1116,190129,2,18
350,418,768,190129,2,19
225,284,509,190129,2,20
130,186,316,190129,2,21
96,132,228,190129,2,22
41,71,112,190129,2,23
21,46,67,190129,2,24
20,14,34,190130,3,1
10,6,16,190130,3,2
3,8,11,190130,3,3
16,16,32,190130,3,4
36,41,77,190130,3,5
211,116,327,190130,3,6
494,367,861,190130,3,7
759,539,1298,190130,3,8
559,393,952,190130,3,9
478,390,868,190130,3,10
418,421,839,190130,3,11
454,469,923,190130,3,12
507,541,1048,190130,3,13
444,521,965,190130,3,14
474,520,994,190130,3,15
520,683,1203,190130,3,16
620,714,1334,190130,3,17
495,606,1101,190130,3,18
306,421,727,190130,3,19
210,236,446,190130,3,20
148,168,316,190130,3,21
89,114,203,190130,3,22
50,79,129,190130,3,23
19,40,59,190130,3,24
22,19,41,190131,4,1
9,11,20,190131,4,2
7,11,18,190131,4,3
13,14,27,190131,4,4
46,45,91,190131,4,5
204,151,355,190131,4,6
481,355,836,190131,4,7
817,510,1327,190131,4,8
558,416,974,190131,4,9
455,407,862,190131,4,10
479,450,929,190131,4,11
446,475,921,190131,4,12
474,542,1016,190131,4,13
486,594,1080,190131,4,14
513,572,1085,190131,4,15
578,623,1201,190131,4,16
637,727,1364,190131,4,17
482,664,1146,190131,4,18
335,498,833,190131,4,19
247,262,509,190131,4,20
153,166,319,190131,4,21
106,153,259,190131,4,22
69,80,149,190131,4,23
28,43,71,190131,4,24
13,15,28,190201,5,1
7,14,21,190201,5,2
8,10,18,190201,5,3
11,7,18,190201,5,4
52,46,98,190201,5,5
189,127,316,190201,5,6
446,327,773,190201,5,7
723,496,1219,190201,5,8
541,375,916,190201,5,9
477,404,881,190201,5,10
460,501,961,190201,5,11
528,563,1091,190201,5,12
614,657,1271,190201,5,13
596,660,1256,190201,5,14
590,653,1243,190201,5,15
508,614,1122,190201,5,16
498,567,1065,190201,5,17
406,483,889,190201,5,18
364,398,762,190201,5,19
215,245,460,190201,5,20
132,178,310,190201,5,21
95,149,244,190201,5,22
74,117,191,190201,5,23
37,73,110,190201,5,24
38,46,84,190202,6,1
24,26,50,190202,6,2
21,23,44,190202,6,3
21,20,41,190202,6,4
24,18,42,190202,6,5
71,55,126,190202,6,6
61,45,106,190202,6,7
114,91,205,190202,6,8
232,153,385,190202,6,9
374,276,650,190202,6,10
443,346,789,190202,6,11
466,447,913,190202,6,12
428,505,933,190202,6,13
406,485,891,190202,6,14
407,436,843,190202,6,15
362,390,752,190202,6,16
342,370,712,190202,6,17
326,338,664,190202,6,18
249,280,529,190202,6,19
142,212,354,190202,6,20
102,154,256,190202,6,21
100,124,224,190202,6,22
77,100,177,190202,6,23
44,73,117,190202,6,24
48,40,88,190203,7,1
35,39,74,190203,7,2
20,24,44,190203,7,3
23,21,44,190203,7,4
17,17,34,190203,7,5
60,29,89,190203,7,6
45,41,86,190203,7,7
60,49,109,190203,7,8
97,65,162,190203,7,9
213,167,380,190203,7,10
361,257,618,190203,7,11
544,389,933,190203,7,12
622,431,1053,190203,7,13
524,516,1040,190203,7,14
487,624,1111,190203,7,15
335,516,851,190203,7,16
303,528,831,190203,7,17
358,420,778,190203,7,18
238,258,496,190203,7,19
143,172,315,190203,7,20
134,145,279,190203,7,21
70,88,158,190203,7,22
32,52,84,190203,7,23
24,22,46,190203,7,24
9,20,29,190204,1,1
9,12,21,190204,1,2
9,10,19,190204,1,3
12,8,20,190204,1,4
45,48,93,190204,1,5
219,152,371,190204,1,6
459,394,853,190204,1,7
826,542,1368,190204,1,8
561,400,961,190204,1,9
463,420,883,190204,1,10
474,446,920,190204,1,11
472,468,940,190204,1,12
475,546,1021,190204,1,13
437,510,947,190204,1,14
505,490,995,190204,1,15
580,660,1240,190204,1,16
606,719,1325,190204,1,17
514,594,1108,190204,1,18
329,433,762,190204,1,19
206,262,468,190204,1,20
152,153,305,190204,1,21
94,120,214,190204,1,22
41,62,103,190204,1,23
20,19,39,190204,1,24
9,14,23,190205,2,1
10,13,23,190205,2,2
12,11,23,190205,2,3
13,13,26,190205,2,4
39,33,72,190205,2,5
197,131,328,190205,2,6
487,391,878,190205,2,7
838,515,1353,190205,2,8
526,414,940,190205,2,9
488,388,876,190205,2,10
447,409,856,190205,2,11
436,481,917,190205,2,12
477,503,980,190205,2,13
464,522,986,190205,2,14
517,531,1048,190205,2,15
523,607,1130,190205,2,16
697,735,1432,190205,2,17
493,595,1088,190205,2,18
330,436,766,190205,2,19
247,279,526,190205,2,20
128,180,308,190205,2,21
91,143,234,190205,2,22
44,80,124,190205,2,23
23,31,54,190205,2,24
13,18,31,190206,3,1
11,6,17,190206,3,2
8,9,17,190206,3,3
12,9,21,190206,3,4
38,34,72,190206,3,5
190,117,307,190206,3,6
506,384,890,190206,3,7
798,553,1351,190206,3,8
594,407,1001,190206,3,9
501,407,908,190206,3,10
425,461,886,190206,3,11
484,495,979,190206,3,12
462,545,1007,190206,3,13
438,529,967,190206,3,14
468,506,974,190206,3,15
495,646,1141,190206,3,16
698,654,1352,190206,3,17
468,552,1020,190206,3,18
331,444,775,190206,3,19
218,267,485,190206,3,20
141,180,321,190206,3,21
88,181,269,190206,3,22
69,72,141,190206,3,23
34,32,66,190206,3,24
17,17,34,190207,4,1
10,13,23,190207,4,2
9,4,13,190207,4,3
11,12,23,190207,4,4
31,30,61,190207,4,5
196,148,344,190207,4,6
491,372,863,190207,4,7
822,496,1318,190207,4,8
558,412,970,190207,4,9
472,407,879,190207,4,10
453,432,885,190207,4,11
447,431,878,190207,4,12
448,526,974,190207,4,13
520,545,1065,190207,4,14
520,539,1059,190207,4,15
552,651,1203,190207,4,16
695,717,1412,190207,4,17
540,578,1118,190207,4,18
332,521,853,190207,4,19
219,294,513,190207,4,20
166,200,366,190207,4,21
121,120,241,190207,4,22
60,76,136,190207,4,23
21,41,62,190207,4,24
15,18,33,190208,5,1
14,12,26,190208,5,2
7,7,14,190208,5,3
11,8,19,190208,5,4
40,36,76,190208,5,5
194,124,318,190208,5,6
444,358,802,190208,5,7
801,483,1284,190208,5,8
506,419,925,190208,5,9
468,382,850,190208,5,10
468,430,898,190208,5,11
553,598,1151,190208,5,12
623,616,1239,190208,5,13
536,676,1212,190208,5,14
552,588,1140,190208,5,15
507,544,1051,190208,5,16
485,553,1038,190208,5,17
395,450,845,190208,5,18
303,406,709,190208,5,19
219,230,449,190208,5,20
137,172,309,190208,5,21
121,118,239,190208,5,22
78,128,206,190208,5,23
50,71,121,190208,5,24
57,41,98,190209,6,1
22,25,47,190209,6,2
22,18,40,190209,6,3
13,14,27,190209,6,4
20,24,44,190209,6,5
61,44,105,190209,6,6
64,54,118,190209,6,7
115,96,211,190209,6,8
243,162,405,190209,6,9
365,279,644,190209,6,10
474,396,870,190209,6,11
482,405,887,190209,6,12
406,420,826,190209,6,13
395,457,852,190209,6,14
372,438,810,190209,6,15
318,354,672,190209,6,16
306,296,602,190209,6,17
348,326,674,190209,6,18
254,268,522,190209,6,19
191,180,371,190209,6,20
127,147,274,190209,6,21
78,112,190,190209,6,22
57,97,154,190209,6,23
41,64,105,190209,6,24
52,62,114,190210,7,1
28,39,67,190210,7,2
22,25,47,190210,7,3
20,23,43,190210,7,4
30,29,59,190210,7,5
52,43,95,190210,7,6
40,44,84,190210,7,7
61,49,110,190210,7,8
111,86,197,190210,7,9
181,169,350,190210,7,10
255,245,500,190210,7,11
282,346,628,190210,7,12
325,280,605,190210,7,13
275,349,624,190210,7,14
320,362,682,190210,7,15
305,292,597,190210,7,16
315,295,610,190210,7,17
294,262,556,190210,7,18
208,219,427,190210,7,19
158,162,320,190210,7,20
120,150,270,190210,7,21
55,94,149,190210,7,22
43,54,97,190210,7,23
16,25,41,190210,7,24
14,12,26,190211,1,1
5,9,14,190211,1,2
6,11,17,190211,1,3
7,7,14,190211,1,4
47,30,77,190211,1,5
204,156,360,190211,1,6
480,389,869,190211,1,7
825,510,1335,190211,1,8
554,395,949,190211,1,9
507,406,913,190211,1,10
500,471,971,190211,1,11
496,536,1032,190211,1,12
472,532,1004,190211,1,13
541,539,1080,190211,1,14
494,533,1027,190211,1,15
570,680,1250,190211,1,16
715,715,1430,190211,1,17
504,652,1156,190211,1,18
325,470,795,190211,1,19
230,268,498,190211,1,20
145,159,304,190211,1,21
111,101,212,190211,1,22
41,65,106,190211,1,23
20,23,43,190211,1,24
13,18,31,190212,2,1
12,8,20,190212,2,2
11,9,20,190212,2,3
5,11,16,190212,2,4
31,33,64,190212,2,5
202,131,333,190212,2,6
464,369,833,190212,2,7
812,533,1345,190212,2,8
561,451,1012,190212,2,9
492,373,865,190212,2,10
485,504,989,190212,2,11
485,476,961,190212,2,12
477,475,952,190212,2,13
500,564,1064,190212,2,14
539,556,1095,190212,2,15
561,670,1231,190212,2,16
719,724,1443,190212,2,17
481,592,1073,190212,2,18
333,483,816,190212,2,19
229,273,502,190212,2,20
139,167,306,190212,2,21
126,104,230,190212,2,22
43,91,134,190212,2,23
36,37,73,190212,2,24
11,14,25,190213,3,1
14,15,29,190213,3,2
7,10,17,190213,3,3
12,16,28,190213,3,4
37,30,67,190213,3,5
179,129,308,190213,3,6
493,376,869,190213,3,7
795,534,1329,190213,3,8
551,380,931,190213,3,9
460,393,853,190213,3,10
473,471,944,190213,3,11
452,480,932,190213,3,12
479,537,1016,190213,3,13
476,608,1084,190213,3,14
482,605,1087,190213,3,15
588,656,1244,190213,3,16
587,736,1323,190213,3,17
512,595,1107,190213,3,18
358,411,769,190213,3,19
224,253,477,190213,3,20
149,196,345,190213,3,21
94,129,223,190213,3,22
66,90,156,190213,3,23
31,39,70,190213,3,24
22,19,41,190214,4,1
12,8,20,190214,4,2
5,10,15,190214,4,3
10,13,23,190214,4,4
39,28,67,190214,4,5
170,143,313,190214,4,6
488,373,861,190214,4,7
839,511,1350,190214,4,8
532,417,949,190214,4,9
480,420,900,190214,4,10
484,465,949,190214,4,11
471,504,975,190214,4,12
505,537,1042,190214,4,13
538,558,1096,190214,4,14
561,583,1144,190214,4,15
629,669,1298,190214,4,16
660,758,1418,190214,4,17
528,629,1157,190214,4,18
329,509,838,190214,4,19
251,285,536,190214,4,20
159,188,347,190214,4,21
134,137,271,190214,4,22
78,100,178,190214,4,23
27,41,68,190214,4,24
3,13,16,190215,5,1
11,11,22,190215,5,2
9,9,18,190215,5,3
9,16,25,190215,5,4
39,26,65,190215,5,5
97,74,171,190215,5,6
430,330,760,190215,5,7
787,506,1293,190215,5,8
539,424,963,190215,5,9
465,408,873,190215,5,10
470,514,984,190215,5,11
589,589,1178,190215,5,12
691,665,1356,190215,5,13
667,737,1404,190215,5,14
623,642,1265,190215,5,15
551,640,1191,190215,5,16
542,593,1135,190215,5,17
428,493,921,190215,5,18
353,436,789,190215,5,19
250,282,532,190215,5,20
114,162,276,190215,5,21
117,159,276,190215,5,22
75,118,193,190215,5,23
66,62,128,190215,5,24
39,36,75,190216,6,1
29,32,61,190216,6,2
12,20,32,190216,6,3
13,18,31,190216,6,4
16,8,24,190216,6,5
55,59,114,190216,6,6
61,45,106,190216,6,7
115,104,219,190216,6,8
242,192,434,190216,6,9
388,346,734,190216,6,10
549,410,959,190216,6,11
507,556,1063,190216,6,12
546,472,1018,190216,6,13
480,460,940,190216,6,14
490,543,1033,190216,6,15
386,482,868,190216,6,16
360,457,817,190216,6,17
389,390,779,190216,6,18
286,310,596,190216,6,19
184,205,389,190216,6,20
131,150,281,190216,6,21
93,114,207,190216,6,22
63,99,162,190216,6,23
48,73,121,190216,6,24
46,56,102,190217,7,1
48,44,92,190217,7,2
19,21,40,190217,7,3
19,22,41,190217,7,4
22,18,40,190217,7,5
37,44,81,190217,7,6
50,40,90,190217,7,7
62,57,119,190217,7,8
104,85,189,190217,7,9
213,206,419,190217,7,10
284,292,576,190217,7,11
403,355,758,190217,7,12
486,353,839,190217,7,13
499,399,898,190217,7,14
428,477,905,190217,7,15
408,474,882,190217,7,16
340,528,868,190217,7,17
356,419,775,190217,7,18
226,222,448,190217,7,19
172,171,343,190217,7,20
96,138,234,190217,7,21
59,84,143,190217,7,22
44,57,101,190217,7,23
18,34,52,190217,7,24
11,24,35,190218,1,1
8,12,20,190218,1,2
9,11,20,190218,1,3
11,11,22,190218,1,4
35,37,72,190218,1,5
216,146,362,190218,1,6
279,231,510,190218,1,7
843,503,1346,190218,1,8
556,436,992,190218,1,9
550,409,959,190218,1,10
494,453,947,190218,1,11
471,499,970,190218,1,12
481,520,1001,190218,1,13
514,613,1127,190218,1,14
559,552,1111,190218,1,15
613,689,1302,190218,1,16
688,726,1414,190218,1,17
515,636,1151,190218,1,18
348,472,820,190218,1,19
228,287,515,190218,1,20
143,151,294,190218,1,21
83,147,230,190218,1,22
46,80,126,190218,1,23
20,31,51,190218,1,24
12,19,31,190219,2,1
7,12,19,190219,2,2
10,4,14,190219,2,3
11,15,26,190219,2,4
33,27,60,190219,2,5
204,140,344,190219,2,6
518,401,919,190219,2,7
853,517,1370,190219,2,8
530,437,967,190219,2,9
507,451,958,190219,2,10
452,456,908,190219,2,11
442,439,881,190219,2,12
415,511,926,190219,2,13
512,565,1077,190219,2,14
497,552,1049,190219,2,15
584,696,1280,190219,2,16
667,744,1411,190219,2,17
521,637,1158,190219,2,18
334,455,789,190219,2,19
236,285,521,190219,2,20
153,177,330,190219,2,21
104,131,235,190219,2,22
45,60,105,190219,2,23
26,34,60,190219,2,24
17,15,32,190220,3,1
6,11,17,190220,3,2
5,5,10,190220,3,3
11,14,25,190220,3,4
39,29,68,190220,3,5
186,139,325,190220,3,6
505,358,863,190220,3,7
830,521,1351,190220,3,8
585,450,1035,190220,3,9
499,401,900,190220,3,10
453,464,917,190220,3,11
467,542,1009,190220,3,12
464,563,1027,190220,3,13
490,508,998,190220,3,14
500,540,1040,190220,3,15
547,640,1187,190220,3,16
632,756,1388,190220,3,17
498,599,1097,190220,3,18
379,395,774,190220,3,19
223,256,479,190220,3,20
125,161,286,190220,3,21
87,158,245,190220,3,22
48,56,104,190220,3,23
31,36,67,190220,3,24
20,13,33,190221,4,1
9,15,24,190221,4,2
11,5,16,190221,4,3
12,15,27,190221,4,4
45,31,76,190221,4,5
198,143,341,190221,4,6
485,385,870,190221,4,7
833,532,1365,190221,4,8
558,429,987,190221,4,9
464,416,880,190221,4,10
452,465,917,190221,4,11
450,487,937,190221,4,12
452,504,956,190221,4,13
481,611,1092,190221,4,14
521,527,1048,190221,4,15
548,660,1208,190221,4,16
691,708,1399,190221,4,17
508,590,1098,190221,4,18
393,480,873,190221,4,19
210,311,521,190221,4,20
163,189,352,190221,4,21
104,146,250,190221,4,22
87,86,173,190221,4,23
35,36,71,190221,4,24
20,21,41,190222,5,1
9,9,18,190222,5,2
8,10,18,190222,5,3
11,13,24,190222,5,4
46,33,79,190222,5,5
186,121,307,190222,5,6
475,365,840,190222,5,7
800,545,1345,190222,5,8
522,390,912,190222,5,9
498,433,931,190222,5,10
506,491,997,190222,5,11
566,524,1090,190222,5,12
592,678,1270,190222,5,13
522,754,1276,190222,5,14
580,643,1223,190222,5,15
549,608,1157,190222,5,16
520,580,1100,190222,5,17
413,500,913,190222,5,18
340,439,779,190222,5,19
215,335,550,190222,5,20
153,176,329,190222,5,21
119,139,258,190222,5,22
83,83,166,190222,5,23
51,62,113,190222,5,24
32,39,71,190223,6,1
22,28,50,190223,6,2
15,12,27,190223,6,3
16,12,28,190223,6,4
21,16,37,190223,6,5
58,42,100,190223,6,6
78,64,142,190223,6,7
79,60,139,190223,6,8
253,177,430,190223,6,9
438,344,782,190223,6,10
503,432,935,190223,6,11
528,481,1009,190223,6,12
513,459,972,190223,6,13
438,463,901,190223,6,14
454,492,946,190223,6,15
351,437,788,190223,6,16
367,458,825,190223,6,17
391,387,778,190223,6,18
305,328,633,190223,6,19
203,252,455,190223,6,20
119,153,272,190223,6,21
85,118,203,190223,6,22
77,82,159,190223,6,23
54,81,135,190223,6,24
48,48,96,190224,7,1
35,37,72,190224,7,2
18,15,33,190224,7,3
22,17,39,190224,7,4
18,22,40,190224,7,5
48,40,88,190224,7,6
39,43,82,190224,7,7
52,47,99,190224,7,8
104,112,216,190224,7,9
248,196,444,190224,7,10
316,308,624,190224,7,11
450,325,775,190224,7,12
516,372,888,190224,7,13
523,433,956,190224,7,14
514,474,988,190224,7,15
389,519,908,190224,7,16
359,543,902,190224,7,17
349,432,781,190224,7,18
230,261,491,190224,7,19
165,231,396,190224,7,20
115,152,267,190224,7,21
74,94,168,190224,7,22
39,51,90,190224,7,23
21,29,50,190224,7,24
11,19,30,190225,1,1
7,9,16,190225,1,2
3,7,10,190225,1,3
9,12,21,190225,1,4
43,42,85,190225,1,5
197,157,354,190225,1,6
496,398,894,190225,1,7
831,509,1340,190225,1,8
586,438,1024,190225,1,9
505,478,983,190225,1,10
482,438,920,190225,1,11
494,521,1015,190225,1,12
507,504,1011,190225,1,13
451,556,1007,190225,1,14
523,531,1054,190225,1,15
605,678,1283,190225,1,16
631,740,1371,190225,1,17
536,633,1169,190225,1,18
356,470,826,190225,1,19
194,274,468,190225,1,20
120,192,312,190225,1,21
87,119,206,190225,1,22
42,52,94,190225,1,23
25,14,39,190225,1,24
8,11,19,190226,2,1
8,12,20,190226,2,2
10,6,16,190226,2,3
9,9,18,190226,2,4
29,41,70,190226,2,5
209,125,334,190226,2,6
485,392,877,190226,2,7
794,513,1307,190226,2,8
570,418,988,190226,2,9
513,419,932,190226,2,10
502,549,1051,190226,2,11
470,513,983,190226,2,12
511,553,1064,190226,2,13
441,516,957,190226,2,14
568,562,1130,190226,2,15
557,725,1282,190226,2,16
684,811,1495,190226,2,17
544,651,1195,190226,2,18
354,488,842,190226,2,19
252,314,566,190226,2,20
135,167,302,190226,2,21
108,110,218,190226,2,22
39,83,122,190226,2,23
26,37,63,190226,2,24
10,17,27,190227,3,1
4,7,11,190227,3,2
9,6,15,190227,3,3
12,12,24,190227,3,4
38,33,71,190227,3,5
200,131,331,190227,3,6
517,406,923,190227,3,7
786,546,1332,190227,3,8
604,437,1041,190227,3,9
537,476,1013,190227,3,10
514,502,1016,190227,3,11
527,495,1022,190227,3,12
558,624,1182,190227,3,13
508,615,1123,190227,3,14
546,655,1201,190227,3,15
573,692,1265,190227,3,16
739,803,1542,190227,3,17
533,618,1151,190227,3,18
396,455,851,190227,3,19
244,319,563,190227,3,20
112,168,280,190227,3,21
96,136,232,190227,3,22
82,76,158,190227,3,23
29,29,58,190227,3,24
23,21,44,190228,4,1
10,7,17,190228,4,2
5,3,8,190228,4,3
12,9,21,190228,4,4
42,37,79,190228,4,5
191,135,326,190228,4,6
483,377,860,190228,4,7
851,534,1385,190228,4,8
542,432,974,190228,4,9
537,447,984,190228,4,10
512,515,1027,190228,4,11
466,464,930,190228,4,12
478,544,1022,190228,4,13
547,552,1099,190228,4,14
574,546,1120,190228,4,15
589,637,1226,190228,4,16
740,689,1429,190228,4,17
484,649,1133,190228,4,18
372,529,901,190228,4,19
231,292,523,190228,4,20
177,199,376,190228,4,21
154,152,306,190228,4,22
52,76,128,190228,4,23
31,37,68,190228,4,24
16,15,31,190301,5,1
8,11,19,190301,5,2
10,10,20,190301,5,3
9,10,19,190301,5,4
35,29,64,190301,5,5
186,142,328,190301,5,6
453,349,802,190301,5,7
768,531,1299,190301,5,8
541,409,950,190301,5,9
491,375,866,190301,5,10
494,475,969,190301,5,11
578,600,1178,190301,5,12
639,606,1245,190301,5,13
599,624,1223,190301,5,14
597,636,1233,190301,5,15
553,519,1072,190301,5,16
552,564,1116,190301,5,17
470,424,894,190301,5,18
367,434,801,190301,5,19
269,291,560,190301,5,20
138,204,342,190301,5,21
105,153,258,190301,5,22
71,121,192,190301,5,23
52,88,140,190301,5,24
35,60,95,190302,6,1
31,23,54,190302,6,2
18,22,40,190302,6,3
13,14,27,190302,6,4
20,27,47,190302,6,5
53,42,95,190302,6,6
79,62,141,190302,6,7
144,106,250,190302,6,8
63,49,112,190302,6,9
421,368,789,190302,6,10
487,463,950,190302,6,11
517,451,968,190302,6,12
483,442,925,190302,6,13
414,499,913,190302,6,14
432,452,884,190302,6,15
379,386,765,190302,6,16
361,414,775,190302,6,17
358,366,724,190302,6,18
270,287,557,190302,6,19
208,151,359,190302,6,20
143,170,313,190302,6,21
112,113,225,190302,6,22
65,89,154,190302,6,23
57,73,130,190302,6,24
50,32,82,190303,7,1
39,44,83,190303,7,2
29,24,53,190303,7,3
15,23,38,190303,7,4
21,22,43,190303,7,5
33,44,77,190303,7,6
43,48,91,190303,7,7
56,51,107,190303,7,8
124,127,251,190303,7,9
226,219,445,190303,7,10
360,281,641,190303,7,11
532,363,895,190303,7,12
570,416,986,190303,7,13
533,518,1051,190303,7,14
508,557,1065,190303,7,15
401,578,979,190303,7,16
340,491,831,190303,7,17
326,418,744,190303,7,18
222,273,495,190303,7,19
160,196,356,190303,7,20
101,128,229,190303,7,21
78,92,170,190303,7,22
44,65,109,190303,7,23
28,31,59,190303,7,24
9,14,23,190304,1,1
6,12,18,190304,1,2
6,9,15,190304,1,3
8,12,20,190304,1,4
51,38,89,190304,1,5
210,147,357,190304,1,6
500,426,926,190304,1,7
841,548,1389,190304,1,8
574,412,986,190304,1,9
527,488,1015,190304,1,10
462,479,941,190304,1,11
475,526,1001,190304,1,12
469,507,976,190304,1,13
509,555,1064,190304,1,14
494,511,1005,190304,1,15
561,678,1239,190304,1,16
643,736,1379,190304,1,17
460,618,1078,190304,1,18
351,412,763,190304,1,19
236,261,497,190304,1,20
131,143,274,190304,1,21
99,111,210,190304,1,22
53,68,121,190304,1,23
19,32,51,190304,1,24
10,10,20,190305,2,1
9,11,20,190305,2,2
7,6,13,190305,2,3
13,9,22,190305,2,4
33,35,68,190305,2,5
186,132,318,190305,2,6
500,397,897,190305,2,7
818,548,1366,190305,2,8
540,415,955,190305,2,9
479,434,913,190305,2,10
468,470,938,190305,2,11
496,477,973,190305,2,12
531,567,1098,190305,2,13
477,582,1059,190305,2,14
540,538,1078,190305,2,15
552,689,1241,190305,2,16
694,756,1450,190305,2,17
516,660,1176,190305,2,18
329,492,821,190305,2,19
234,283,517,190305,2,20
162,176,338,190305,2,21
87,99,186,190305,2,22
54,70,124,190305,2,23
32,59,91,190305,2,24
14,25,39,190306,3,1
8,9,17,190306,3,2
10,9,19,190306,3,3
7,9,16,190306,3,4
42,36,78,190306,3,5
204,128,332,190306,3,6
493,403,896,190306,3,7
791,536,1327,190306,3,8
581,459,1040,190306,3,9
519,422,941,190306,3,10
506,505,1011,190306,3,11
475,514,989,190306,3,12
510,530,1040,190306,3,13
422,561,983,190306,3,14
478,588,1066,190306,3,15
558,697,1255,190306,3,16
699,754,1453,190306,3,17
492,611,1103,190306,3,18
366,422,788,190306,3,19
236,278,514,190306,3,20
135,183,318,190306,3,21
94,126,220,190306,3,22
63,86,149,190306,3,23
29,31,60,190306,3,24
21,16,37,190307,4,1
8,12,20,190307,4,2
9,10,19,190307,4,3
12,14,26,190307,4,4
47,36,83,190307,4,5
176,139,315,190307,4,6
486,380,866,190307,4,7
848,541,1389,190307,4,8
562,444,1006,190307,4,9
508,423,931,190307,4,10
467,502,969,190307,4,11
497,485,982,190307,4,12
542,571,1113,190307,4,13
496,558,1054,190307,4,14
524,629,1153,190307,4,15
590,705,1295,190307,4,16
706,718,1424,190307,4,17
530,586,1116,190307,4,18
372,522,894,190307,4,19
304,329,633,190307,4,20
170,200,370,190307,4,21
122,145,267,190307,4,22
75,120,195,190307,4,23
26,54,80,190307,4,24
17,17,34,190308,5,1
5,6,11,190308,5,2
6,12,18,190308,5,3
10,12,22,190308,5,4
46,28,74,190308,5,5
181,130,311,190308,5,6
457,354,811,190308,5,7
776,497,1273,190308,5,8
548,430,978,190308,5,9
488,471,959,190308,5,10
512,491,1003,190308,5,11
571,574,1145,190308,5,12
639,652,1291,190308,5,13
597,676,1273,190308,5,14
618,696,1314,190308,5,15
549,630,1179,190308,5,16
519,615,1134,190308,5,17
437,528,965,190308,5,18
381,404,785,190308,5,19
276,278,554,190308,5,20
140,163,303,190308,5,21
122,129,251,190308,5,22
83,119,202,190308,5,23
64,81,145,190308,5,24
25,36,61,190309,6,1
18,35,53,190309,6,2
12,22,34,190309,6,3
16,22,38,190309,6,4
14,20,34,190309,6,5
66,51,117,190309,6,6
63,51,114,190309,6,7
141,110,251,190309,6,8
247,209,456,190309,6,9
398,371,769,190309,6,10
486,447,933,190309,6,11
500,470,970,190309,6,12
493,425,918,190309,6,13
414,506,920,190309,6,14
369,442,811,190309,6,15
342,402,744,190309,6,16
376,368,744,190309,6,17
357,336,693,190309,6,18
272,294,566,190309,6,19
183,207,390,190309,6,20
116,170,286,190309,6,21
85,136,221,190309,6,22
68,135,203,190309,6,23
62,86,148,190309,6,24
71,54,125,190310,7,1
68,36,104,190310,7,2
48,33,81,190310,7,3
40,20,60,190310,7,4
17,24,41,190310,7,5
45,40,85,190310,7,6
40,33,73,190310,7,7
48,47,95,190310,7,8
94,88,182,190310,7,9
216,230,446,190310,7,10
299,277,576,190310,7,11
307,327,634,190310,7,12
391,344,735,190310,7,13
378,367,745,190310,7,14
410,396,806,190310,7,15
335,360,695,190310,7,16
302,340,642,190310,7,17
351,339,690,190310,7,18
217,277,494,190310,7,19
133,191,324,190310,7,20
109,145,254,190310,7,21
81,93,174,190310,7,22
44,63,107,190310,7,23
19,32,51,190310,7,24
7,19,26,190311,1,1
6,10,16,190311,1,2
8,14,22,190311,1,3
8,9,17,190311,1,4
53,30,83,190311,1,5
209,150,359,190311,1,6
526,416,942,190311,1,7
804,550,1354,190311,1,8
542,397,939,190311,1,9
520,434,954,190311,1,10
496,536,1032,190311,1,11
518,491,1009,190311,1,12
510,489,999,190311,1,13
452,519,971,190311,1,14
495,523,1018,190311,1,15
543,618,1161,190311,1,16
646,794,1440,190311,1,17
500,613,1113,190311,1,18
373,454,827,190311,1,19
264,268,532,190311,1,20
136,142,278,190311,1,21
100,120,220,190311,1,22
57,83,140,190311,1,23
18,18,36,190311,1,24
13,18,31,190312,2,1
7,5,12,190312,2,2
5,11,16,190312,2,3
11,10,21,190312,2,4
37,32,69,190312,2,5
193,125,318,190312,2,6
515,395,910,190312,2,7
791,515,1306,190312,2,8
551,406,957,190312,2,9
484,444,928,190312,2,10
525,482,1007,190312,2,11
499,530,1029,190312,2,12
434,486,920,190312,2,13
431,606,1037,190312,2,14
130,122,252,190312,2,15
558,643,1201,190312,2,16
672,667,1339,190312,2,17
525,597,1122,190312,2,18
339,474,813,190312,2,19
214,272,486,190312,2,20
157,175,332,190312,2,21
92,111,203,190312,2,22
71,86,157,190312,2,23
28,33,61,190312,2,24
6,13,19,190313,3,1
9,11,20,190313,3,2
8,4,12,190313,3,3
7,9,16,190313,3,4
37,34,71,190313,3,5
200,125,325,190313,3,6
499,395,894,190313,3,7
831,553,1384,190313,3,8
551,443,994,190313,3,9
481,467,948,190313,3,10
479,504,983,190313,3,11
494,534,1028,190313,3,12
499,534,1033,190313,3,13
453,518,971,190313,3,14
510,568,1078,190313,3,15
450,657,1107,190313,3,16
643,669,1312,190313,3,17
453,567,1020,190313,3,18
357,483,840,190313,3,19
294,291,585,190313,3,20
130,154,284,190313,3,21
105,139,244,190313,3,22
72,85,157,190313,3,23
22,34,56,190313,3,24
18,18,36,190314,4,1
12,9,21,190314,4,2
12,11,23,190314,4,3
12,13,25,190314,4,4
36,29,65,190314,4,5
188,130,318,190314,4,6
487,406,893,190314,4,7
847,503,1350,190314,4,8
537,420,957,190314,4,9
504,446,950,190314,4,10
492,491,983,190314,4,11
458,483,941,190314,4,12
516,574,1090,190314,4,13
489,556,1045,190314,4,14
501,511,1012,190314,4,15
556,598,1154,190314,4,16
712,699,1411,190314,4,17
550,641,1191,190314,4,18
389,540,929,190314,4,19
234,278,512,190314,4,20
163,188,351,190314,4,21
119,170,289,190314,4,22
67,80,147,190314,4,23
41,44,85,190314,4,24
14,20,34,190315,5,1
4,8,12,190315,5,2
13,10,23,190315,5,3
9,13,22,190315,5,4
50,29,79,190315,5,5
178,130,308,190315,5,6
461,374,835,190315,5,7
764,513,1277,190315,5,8
501,438,939,190315,5,9
511,436,947,190315,5,10
508,491,999,190315,5,11
564,550,1114,190315,5,12
585,628,1213,190315,5,13
579,672,1251,190315,5,14
542,616,1158,190315,5,15
510,537,1047,190315,5,16
528,621,1149,190315,5,17
456,500,956,190315,5,18
350,446,796,190315,5,19
278,266,544,190315,5,20
129,180,309,190315,5,21
93,165,258,190315,5,22
89,120,209,190315,5,23
54,85,139,190315,5,24
24,39,63,190316,6,1
20,28,48,190316,6,2
23,25,48,190316,6,3
25,15,40,190316,6,4
24,23,47,190316,6,5
53,49,102,190316,6,6
70,70,140,190316,6,7
149,114,263,190316,6,8
288,205,493,190316,6,9
436,346,782,190316,6,10
507,448,955,190316,6,11
499,512,1011,190316,6,12
464,459,923,190316,6,13
387,419,806,190316,6,14
387,438,825,190316,6,15
373,365,738,190316,6,16
337,380,717,190316,6,17
336,366,702,190316,6,18
260,327,587,190316,6,19
226,201,427,190316,6,20
143,157,300,190316,6,21
82,105,187,190316,6,22
90,141,231,190316,6,23
71,86,157,190316,6,24
64,53,117,190317,7,1
40,51,91,190317,7,2
27,28,55,190317,7,3
33,23,56,190317,7,4
19,19,38,190317,7,5
41,36,77,190317,7,6
40,39,79,190317,7,7
37,37,74,190317,7,8
96,92,188,190317,7,9
233,208,441,190317,7,10
307,307,614,190317,7,11
317,347,664,190317,7,12
452,339,791,190317,7,13
415,402,817,190317,7,14
450,443,893,190317,7,15
380,388,768,190317,7,16
366,419,785,190317,7,17
310,386,696,190317,7,18
231,250,481,190317,7,19
165,202,367,190317,7,20
129,131,260,190317,7,21
82,82,164,190317,7,22
49,48,97,190317,7,23
13,29,42,190317,7,24
17,25,42,190318,1,1
5,12,17,190318,1,2
6,9,15,190318,1,3
11,12,23,190318,1,4
44,39,83,190318,1,5
206,186,392,190318,1,6
510,416,926,190318,1,7
807,539,1346,190318,1,8
591,448,1039,190318,1,9
526,437,963,190318,1,10
522,545,1067,190318,1,11
493,488,981,190318,1,12
468,519,987,190318,1,13
464,530,994,190318,1,14
545,573,1118,190318,1,15
577,628,1205,190318,1,16
683,705,1388,190318,1,17
546,638,1184,190318,1,18
329,487,816,190318,1,19
237,270,507,190318,1,20
143,175,318,190318,1,21
119,112,231,190318,1,22
47,67,114,190318,1,23
20,23,43,190318,1,24
11,17,28,190319,2,1
7,6,13,190319,2,2
11,12,23,190319,2,3
13,11,24,190319,2,4
28,32,60,190319,2,5
204,133,337,190319,2,6
505,387,892,190319,2,7
852,539,1391,190319,2,8
563,416,979,190319,2,9
505,478,983,190319,2,10
523,465,988,190319,2,11
519,506,1025,190319,2,12
490,539,1029,190319,2,13
485,609,1094,190319,2,14
570,564,1134,190319,2,15
600,674,1274,190319,2,16
731,726,1457,190319,2,17
513,637,1150,190319,2,18
349,503,852,190319,2,19
249,303,552,190319,2,20
177,195,372,190319,2,21
100,135,235,190319,2,22
72,84,156,190319,2,23
17,32,49,190319,2,24
17,10,27,190320,3,1
8,7,15,190320,3,2
5,15,20,190320,3,3
12,8,20,190320,3,4
36,30,66,190320,3,5
206,132,338,190320,3,6
502,380,882,190320,3,7
809,535,1344,190320,3,8
570,449,1019,190320,3,9
531,423,954,190320,3,10
521,495,1016,190320,3,11
482,537,1019,190320,3,12
518,521,1039,190320,3,13
463,539,1002,190320,3,14
504,569,1073,190320,3,15
571,632,1203,190320,3,16
702,690,1392,190320,3,17
500,625,1125,190320,3,18
387,471,858,190320,3,19
253,299,552,190320,3,20
170,172,342,190320,3,21
108,156,264,190320,3,22
63,89,152,190320,3,23
32,28,60,190320,3,24
19,21,40,190321,4,1
9,12,21,190321,4,2
5,6,11,190321,4,3
11,9,20,190321,4,4
40,37,77,190321,4,5
199,120,319,190321,4,6
507,373,880,190321,4,7
848,574,1422,190321,4,8
555,434,989,190321,4,9
470,435,905,190321,4,10
501,450,951,190321,4,11
392,434,826,190321,4,12
500,579,1079,190321,4,13
511,548,1059,190321,4,14
509,603,1112,190321,4,15
587,652,1239,190321,4,16
693,752,1445,190321,4,17
525,660,1185,190321,4,18
361,545,906,190321,4,19
235,338,573,190321,4,20
168,191,359,190321,4,21
162,122,284,190321,4,22
96,101,197,190321,4,23
39,40,79,190321,4,24
10,20,30,190322,5,1
13,12,25,190322,5,2
6,8,14,190322,5,3
13,7,20,190322,5,4
36,39,75,190322,5,5
201,112,313,190322,5,6
462,376,838,190322,5,7
784,531,1315,190322,5,8
519,446,965,190322,5,9
498,439,937,190322,5,10
545,520,1065,190322,5,11
587,599,1186,190322,5,12
663,693,1356,190322,5,13
626,757,1383,190322,5,14
595,698,1293,190322,5,15
543,601,1144,190322,5,16
545,612,1157,190322,5,17
493,518,1011,190322,5,18
388,472,860,190322,5,19
308,325,633,190322,5,20
179,235,414,190322,5,21
104,143,247,190322,5,22
97,168,265,190322,5,23
98,70,168,190322,5,24
43,44,87,190323,6,1
21,27,48,190323,6,2
18,16,34,190323,6,3
25,24,49,190323,6,4
21,25,46,190323,6,5
62,46,108,190323,6,6
83,67,150,190323,6,7
134,113,247,190323,6,8
284,218,502,190323,6,9
454,364,818,190323,6,10
517,463,980,190323,6,11
507,498,1005,190323,6,12
502,543,1045,190323,6,13
480,500,980,190323,6,14
474,504,978,190323,6,15
430,468,898,190323,6,16
377,416,793,190323,6,17
348,388,736,190323,6,18
315,343,658,190323,6,19
208,235,443,190323,6,20
149,191,340,190323,6,21
103,143,246,190323,6,22
93,116,209,190323,6,23
53,64,117,190323,6,24
49,48,97,190324,7,1
36,43,79,190324,7,2
29,24,53,190324,7,3
19,17,36,190324,7,4
19,21,40,190324,7,5
47,38,85,190324,7,6
41,39,80,190324,7,7
42,53,95,190324,7,8
136,100,236,190324,7,9
232,246,478,190324,7,10
312,262,574,190324,7,11
441,375,816,190324,7,12
447,363,810,190324,7,13
487,449,936,190324,7,14
539,483,1022,190324,7,15
443,479,922,190324,7,16
428,530,958,190324,7,17
412,522,934,190324,7,18
275,331,606,190324,7,19
220,199,419,190324,7,20
141,150,291,190324,7,21
80,97,177,190324,7,22
47,67,114,190324,7,23
14,29,43,190324,7,24
12,12,24,190325,1,1
8,10,18,190325,1,2
4,9,13,190325,1,3
13,13,26,190325,1,4
43,29,72,190325,1,5
215,145,360,190325,1,6
512,446,958,190325,1,7
800,514,1314,190325,1,8
599,455,1054,190325,1,9
540,487,1027,190325,1,10
510,497,1007,190325,1,11
492,512,1004,190325,1,12
519,479,998,190325,1,13
462,553,1015,190325,1,14
509,521,1030,190325,1,15
551,658,1209,190325,1,16
720,726,1446,190325,1,17
499,699,1198,190325,1,18
382,477,859,190325,1,19
253,296,549,190325,1,20
143,154,297,190325,1,21
97,147,244,190325,1,22
64,72,136,190325,1,23
18,29,47,190325,1,24
12,13,25,190326,2,1
9,6,15,190326,2,2
8,12,20,190326,2,3
17,12,29,190326,2,4
31,31,62,190326,2,5
199,135,334,190326,2,6
526,460,986,190326,2,7
827,541,1368,190326,2,8
609,483,1092,190326,2,9
503,498,1001,190326,2,10
528,579,1107,190326,2,11
481,522,1003,190326,2,12
493,604,1097,190326,2,13
518,644,1162,190326,2,14
574,609,1183,190326,2,15
557,766,1323,190326,2,16
762,811,1573,190326,2,17
556,718,1274,190326,2,18
382,491,873,190326,2,19
251,319,570,190326,2,20
169,187,356,190326,2,21
109,120,229,190326,2,22
52,97,149,190326,2,23
22,34,56,190326,2,24
13,14,27,190327,3,1
6,9,15,190327,3,2
8,7,15,190327,3,3
11,7,18,190327,3,4
38,31,69,190327,3,5
198,135,333,190327,3,6
495,384,879,190327,3,7
800,594,1394,190327,3,8
560,456,1016,190327,3,9
517,483,1000,190327,3,10
534,528,1062,190327,3,11
518,522,1040,190327,3,12
514,597,1111,190327,3,13
518,581,1099,190327,3,14
488,613,1101,190327,3,15
552,702,1254,190327,3,16
714,733,1447,190327,3,17
496,651,1147,190327,3,18
394,569,963,190327,3,19
238,303,541,190327,3,20
167,186,353,190327,3,21
132,132,264,190327,3,22
80,81,161,190327,3,23
22,34,56,190327,3,24
19,10,29,190328,4,1
7,12,19,190328,4,2
7,9,16,190328,4,3
12,12,24,190328,4,4
36,37,73,190328,4,5
200,145,345,190328,4,6
496,420,916,190328,4,7
834,562,1396,190328,4,8
598,503,1101,190328,4,9
544,489,1033,190328,4,10
526,513,1039,190328,4,11
462,522,984,190328,4,12
542,571,1113,190328,4,13
563,596,1159,190328,4,14
589,620,1209,190328,4,15
586,715,1301,190328,4,16
789,807,1596,190328,4,17
517,742,1259,190328,4,18
377,528,905,190328,4,19
248,325,573,190328,4,20
199,195,394,190328,4,21
122,176,298,190328,4,22
97,101,198,190328,4,23
29,41,70,190328,4,24
17,24,41,190329,5,1
5,11,16,190329,5,2
11,11,22,190329,5,3
11,9,20,190329,5,4
45,30,75,190329,5,5
192,125,317,190329,5,6
475,390,865,190329,5,7
833,526,1359,190329,5,8
577,491,1068,190329,5,9
541,465,1006,190329,5,10
603,539,1142,190329,5,11
621,665,1286,190329,5,12
671,703,1374,190329,5,13
654,781,1435,190329,5,14
675,755,1430,190329,5,15
593,644,1237,190329,5,16
576,614,1190,190329,5,17
506,568,1074,190329,5,18
440,495,935,190329,5,19
294,324,618,190329,5,20
163,199,362,190329,5,21
129,166,295,190329,5,22
105,134,239,190329,5,23
51,72,123,190329,5,24
41,46,87,190330,6,1
29,27,56,190330,6,2
14,18,32,190330,6,3
16,15,31,190330,6,4
25,22,47,190330,6,5
73,59,132,190330,6,6
92,76,168,190330,6,7
154,128,282,190330,6,8
360,287,647,190330,6,9
520,439,959,190330,6,10
628,496,1124,190330,6,11
591,548,1139,190330,6,12
583,562,1145,190330,6,13
498,588,1086,190330,6,14
513,473,986,190330,6,15
377,485,862,190330,6,16
395,468,863,190330,6,17
410,426,836,190330,6,18
318,350,668,190330,6,19
213,291,504,190330,6,20
161,192,353,190330,6,21
95,124,219,190330,6,22
77,95,172,190330,6,23
66,78,144,190330,6,24
36,54,90,190331,7,1
37,29,66,190331,7,2
0,0,0,190331,7,3
30,24,54,190331,7,4
22,36,58,190331,7,5
53,48,101,190331,7,6
45,46,91,190331,7,7
69,63,132,190331,7,8
123,110,233,190331,7,9
225,210,435,190331,7,10
333,305,638,190331,7,11
450,368,818,190331,7,12
497,446,943,190331,7,13
505,461,966,190331,7,14
534,518,1052,190331,7,15
437,551,988,190331,7,16
416,548,964,190331,7,17
360,464,824,190331,7,18
282,305,587,190331,7,19
216,252,468,190331,7,20
142,140,282,190331,7,21
89,121,210,190331,7,22
53,85,138,190331,7,23
21,45,66,190331,7,24
12,32,44,190401,1,1
6,9,15,190401,1,2
9,11,20,190401,1,3
14,12,26,190401,1,4
45,34,79,190401,1,5
169,151,320,190401,1,6
524,453,977,190401,1,7
841,551,1392,190401,1,8
576,433,1009,190401,1,9
556,453,1009,190401,1,10
518,527,1045,190401,1,11
511,532,1043,190401,1,12
526,526,1052,190401,1,13
539,606,1145,190401,1,14
504,565,1069,190401,1,15
620,700,1320,190401,1,16
731,786,1517,190401,1,17
531,639,1170,190401,1,18
425,510,935,190401,1,19
302,327,629,190401,1,20
135,193,328,190401,1,21
120,122,242,190401,1,22
46,89,135,190401,1,23
34,28,62,190401,1,24
6,13,19,190402,2,1
6,5,11,190402,2,2
10,8,18,190402,2,3
14,13,27,190402,2,4
38,31,69,190402,2,5
197,152,349,190402,2,6
542,388,930,190402,2,7
823,532,1355,190402,2,8
590,460,1050,190402,2,9
545,494,1039,190402,2,10
536,492,1028,190402,2,11
495,520,1015,190402,2,12
499,527,1026,190402,2,13
534,600,1134,190402,2,14
574,610,1184,190402,2,15
637,643,1280,190402,2,16
772,802,1574,190402,2,17
578,668,1246,190402,2,18
406,561,967,190402,2,19
255,320,575,190402,2,20
168,187,355,190402,2,21
129,166,295,190402,2,22
68,104,172,190402,2,23
34,46,80,190402,2,24
12,17,29,190403,3,1
13,12,25,190403,3,2
22,16,38,190403,3,3
27,16,43,190403,3,4
59,45,104,190403,3,5
200,137,337,190403,3,6
512,402,914,190403,3,7
830,549,1379,190403,3,8
598,452,1050,190403,3,9
527,484,1011,190403,3,10
499,497,996,190403,3,11
489,515,1004,190403,3,12
538,602,1140,190403,3,13
520,666,1186,190403,3,14
530,595,1125,190403,3,15
570,662,1232,190403,3,16
662,707,1369,190403,3,17
547,535,1082,190403,3,18
412,398,810,190403,3,19
295,297,592,190403,3,20
185,186,371,190403,3,21
119,178,297,190403,3,22
74,139,213,190403,3,23
32,28,60,190403,3,24
28,19,47,190404,4,1
8,12,20,190404,4,2
6,6,12,190404,4,3
8,8,16,190404,4,4
40,32,72,190404,4,5
185,151,336,190404,4,6
488,372,860,190404,4,7
722,485,1207,190404,4,8
529,444,973,190404,4,9
548,461,1009,190404,4,10
515,492,1007,190404,4,11
543,516,1059,190404,4,12
488,561,1049,190404,4,13
549,521,1070,190404,4,14
612,608,1220,190404,4,15
585,679,1264,190404,4,16
776,750,1526,190404,4,17
536,723,1259,190404,4,18
429,536,965,190404,4,19
265,334,599,190404,4,20
194,188,382,190404,4,21
114,170,284,190404,4,22
83,95,178,190404,4,23
28,39,67,190404,4,24
21,17,38,190405,5,1
6,13,19,190405,5,2
11,12,23,190405,5,3
16,15,31,190405,5,4
49,36,85,190405,5,5
170,130,300,190405,5,6
489,349,838,190405,5,7
642,476,1118,190405,5,8
494,405,899,190405,5,9
574,465,1039,190405,5,10
564,552,1116,190405,5,11
608,579,1187,190405,5,12
606,667,1273,190405,5,13
643,723,1366,190405,5,14
588,640,1228,190405,5,15
535,577,1112,190405,5,16
562,534,1096,190405,5,17
485,524,1009,190405,5,18
368,389,757,190405,5,19
236,280,516,190405,5,20
161,211,372,190405,5,21
124,127,251,190405,5,22
85,106,191,190405,5,23
53,69,122,190405,5,24
41,51,92,190406,6,1
22,25,47,190406,6,2
14,18,32,190406,6,3
17,13,30,190406,6,4
19,18,37,190406,6,5
69,43,112,190406,6,6
83,88,171,190406,6,7
153,108,261,190406,6,8
284,251,535,190406,6,9
458,413,871,190406,6,10
565,558,1123,190406,6,11
626,564,1190,190406,6,12
478,528,1006,190406,6,13
456,491,947,190406,6,14
478,470,948,190406,6,15
379,512,891,190406,6,16
359,447,806,190406,6,17
408,382,790,190406,6,18
315,347,662,190406,6,19
226,196,422,190406,6,20
174,186,360,190406,6,21
90,109,199,190406,6,22
66,97,163,190406,6,23
52,94,146,190406,6,24
50,59,109,190407,7,1
33,39,72,190407,7,2
15,23,38,190407,7,3
22,20,42,190407,7,4
16,20,36,190407,7,5
59,43,102,190407,7,6
53,46,99,190407,7,7
79,75,154,190407,7,8
141,123,264,190407,7,9
344,230,574,190407,7,10
521,322,843,190407,7,11
611,394,1005,190407,7,12
588,501,1089,190407,7,13
606,521,1127,190407,7,14
534,597,1131,190407,7,15
354,613,967,190407,7,16
361,581,942,190407,7,17
346,534,880,190407,7,18
255,396,651,190407,7,19
232,225,457,190407,7,20
146,183,329,190407,7,21
94,101,195,190407,7,22
42,48,90,190407,7,23
17,41,58,190407,7,24
9,28,37,190408,1,1
6,7,13,190408,1,2
8,10,18,190408,1,3
10,8,18,190408,1,4
44,36,80,190408,1,5
213,148,361,190408,1,6
507,405,912,190408,1,7
720,504,1224,190408,1,8
570,428,998,190408,1,9
554,496,1050,190408,1,10
574,563,1137,190408,1,11
526,568,1094,190408,1,12
585,618,1203,190408,1,13
563,643,1206,190408,1,14
587,588,1175,190408,1,15
605,693,1298,190408,1,16
705,787,1492,190408,1,17
517,651,1168,190408,1,18
357,508,865,190408,1,19
261,294,555,190408,1,20
166,203,369,190408,1,21
125,117,242,190408,1,22
52,85,137,190408,1,23
19,28,47,190408,1,24
13,16,29,190409,2,1
8,8,16,190409,2,2
7,9,16,190409,2,3
13,13,26,190409,2,4
42,38,80,190409,2,5
197,135,332,190409,2,6
521,392,913,190409,2,7
708,489,1197,190409,2,8
517,447,964,190409,2,9
557,498,1055,190409,2,10
529,536,1065,190409,2,11
546,484,1030,190409,2,12
544,552,1096,190409,2,13
556,549,1105,190409,2,14
598,614,1212,190409,2,15
635,665,1300,190409,2,16
745,809,1554,190409,2,17
533,755,1288,190409,2,18
446,578,1024,190409,2,19
312,382,694,190409,2,20
179,204,383,190409,2,21
113,136,249,190409,2,22
53,69,122,190409,2,23
30,25,55,190409,2,24
19,15,34,190410,3,1
4,13,17,190410,3,2
8,7,15,190410,3,3
11,8,19,190410,3,4
44,32,76,190410,3,5
200,133,333,190410,3,6
508,380,888,190410,3,7
683,446,1129,190410,3,8
582,483,1065,190410,3,9
616,465,1081,190410,3,10
552,590,1142,190410,3,11
603,553,1156,190410,3,12
559,625,1184,190410,3,13
599,594,1193,190410,3,14
580,667,1247,190410,3,15
593,699,1292,190410,3,16
731,774,1505,190410,3,17
561,635,1196,190410,3,18
418,503,921,190410,3,19
266,317,583,190410,3,20
196,167,363,190410,3,21
103,176,279,190410,3,22
66,84,150,190410,3,23
37,49,86,190410,3,24
28,23,51,190411,4,1
7,12,19,190411,4,2
7,7,14,190411,4,3
13,12,25,190411,4,4
38,33,71,190411,4,5
204,147,351,190411,4,6
500,380,880,190411,4,7
691,431,1122,190411,4,8
556,441,997,190411,4,9
541,476,1017,190411,4,10
510,530,1040,190411,4,11
523,551,1074,190411,4,12
594,521,1115,190411,4,13
595,600,1195,190411,4,14
601,566,1167,190411,4,15
741,706,1447,190411,4,16
894,679,1573,190411,4,17
716,672,1388,190411,4,18
574,532,1106,190411,4,19
354,312,666,190411,4,20
189,226,415,190411,4,21
111,145,256,190411,4,22
51,95,146,190411,4,23
19,35,54,190411,4,24
13,15,28,190412,5,1
9,18,27,190412,5,2
12,11,23,190412,5,3
12,9,21,190412,5,4
43,25,68,190412,5,5
177,134,311,190412,5,6
482,368,850,190412,5,7
647,396,1043,190412,5,8
530,428,958,190412,5,9
508,450,958,190412,5,10
595,557,1152,190412,5,11
602,596,1198,190412,5,12
624,655,1279,190412,5,13
742,681,1423,190412,5,14
666,668,1334,190412,5,15
624,610,1234,190412,5,16
522,550,1072,190412,5,17
512,494,1006,190412,5,18
363,440,803,190412,5,19
261,270,531,190412,5,20
229,247,476,190412,5,21
131,153,284,190412,5,22
82,98,180,190412,5,23
66,63,129,190412,5,24
39,41,80,190413,6,1
19,23,42,190413,6,2
11,17,28,190413,6,3
15,19,34,190413,6,4
20,27,47,190413,6,5
59,53,112,190413,6,6
68,79,147,190413,6,7
125,124,249,190413,6,8
246,223,469,190413,6,9
446,375,821,190413,6,10
508,424,932,190413,6,11
495,517,1012,190413,6,12
498,515,1013,190413,6,13
520,492,1012,190413,6,14
584,455,1039,190413,6,15
404,390,794,190413,6,16
345,316,661,190413,6,17
373,338,711,190413,6,18
272,311,583,190413,6,19
178,204,382,190413,6,20
118,155,273,190413,6,21
92,122,214,190413,6,22
108,87,195,190413,6,23
51,66,117,190413,6,24
42,32,74,190414,7,1
34,25,59,190414,7,2
26,24,50,190414,7,3
24,26,50,190414,7,4
16,21,37,190414,7,5
38,46,84,190414,7,6
51,39,90,190414,7,7
41,69,110,190414,7,8
91,90,181,190414,7,9
189,175,364,190414,7,10
277,302,579,190414,7,11
361,389,750,190414,7,12
482,346,828,190414,7,13
415,414,829,190414,7,14
473,453,926,190414,7,15
390,413,803,190414,7,16
341,405,746,190414,7,17
319,389,708,190414,7,18
265,328,593,190414,7,19
184,207,391,190414,7,20
133,173,306,190414,7,21
79,100,179,190414,7,22
50,61,111,190414,7,23
25,30,55,190414,7,24
17,19,36,190415,1,1
13,16,29,190415,1,2
8,10,18,190415,1,3
11,11,22,190415,1,4
44,30,74,190415,1,5
178,145,323,190415,1,6
443,365,808,190415,1,7
657,422,1079,190415,1,8
537,430,967,190415,1,9
545,486,1031,190415,1,10
535,527,1062,190415,1,11
545,508,1053,190415,1,12
516,510,1026,190415,1,13
499,516,1015,190415,1,14
530,514,1044,190415,1,15
552,587,1139,190415,1,16
661,690,1351,190415,1,17
499,628,1127,190415,1,18
372,476,848,190415,1,19
268,304,572,190415,1,20
177,189,366,190415,1,21
89,115,204,190415,1,22
53,63,116,190415,1,23
25,45,70,190415,1,24
12,17,29,190416,2,1
6,9,15,190416,2,2
12,12,24,190416,2,3
10,13,23,190416,2,4
39,35,74,190416,2,5
171,128,299,190416,2,6
472,344,816,190416,2,7
636,411,1047,190416,2,8
508,403,911,190416,2,9
537,457,994,190416,2,10
566,524,1090,190416,2,11
559,534,1093,190416,2,12
511,543,1054,190416,2,13
505,527,1032,190416,2,14
556,537,1093,190416,2,15
558,614,1172,190416,2,16
679,709,1388,190416,2,17
520,699,1219,190416,2,18
373,523,896,190416,2,19
275,302,577,190416,2,20
179,226,405,190416,2,21
112,132,244,190416,2,22
69,97,166,190416,2,23
34,34,68,190416,2,24
17,19,36,190417,3,1
10,9,19,190417,3,2
13,10,23,190417,3,3
9,9,18,190417,3,4
38,35,73,190417,3,5
168,121,289,190417,3,6
452,350,802,190417,3,7
604,451,1055,190417,3,8
578,441,1019,190417,3,9
556,475,1031,190417,3,10
594,604,1198,190417,3,11
595,605,1200,190417,3,12
526,578,1104,190417,3,13
550,580,1130,190417,3,14
559,599,1158,190417,3,15
635,687,1322,190417,3,16
737,719,1456,190417,3,17
518,649,1167,190417,3,18
417,502,919,190417,3,19
290,335,625,190417,3,20
193,215,408,190417,3,21
143,149,292,190417,3,22
62,84,146,190417,3,23
37,39,76,190417,3,24
28,29,57,190418,4,1
10,14,24,190418,4,2
11,13,24,190418,4,3
11,14,25,190418,4,4
34,32,66,190418,4,5
178,123,301,190418,4,6
446,324,770,190418,4,7
599,415,1014,190418,4,8
517,409,926,190418,4,9
591,476,1067,190418,4,10
625,567,1192,190418,4,11
632,644,1276,190418,4,12
596,633,1229,190418,4,13
648,582,1230,190418,4,14
668,640,1308,190418,4,15
700,728,1428,190418,4,16
680,763,1443,190418,4,17
548,636,1184,190418,4,18
464,572,1036,190418,4,19
329,404,733,190418,4,20
222,259,481,190418,4,21
139,151,290,190418,4,22
112,130,242,190418,4,23
71,75,146,190418,4,24
34,35,69,190419,5,1
21,23,44,190419,5,2
16,12,28,190419,5,3
19,17,36,190419,5,4
24,17,41,190419,5,5
40,42,82,190419,5,6
50,48,98,190419,5,7
66,64,130,190419,5,8
124,137,261,190419,5,9
295,263,558,190419,5,10
396,471,867,190419,5,11
378,461,839,190419,5,12
435,472,907,190419,5,13
492,449,941,190419,5,14
551,457,1008,190419,5,15
468,436,904,190419,5,16
452,500,952,190419,5,17
422,509,931,190419,5,18
361,358,719,190419,5,19
236,258,494,190419,5,20
182,202,384,190419,5,21
112,138,250,190419,5,22
63,86,149,190419,5,23
45,52,97,190419,5,24
37,35,72,190420,6,1
17,24,41,190420,6,2
19,19,38,190420,6,3
11,15,26,190420,6,4
22,17,39,190420,6,5
77,52,129,190420,6,6
91,65,156,190420,6,7
201,132,333,190420,6,8
387,288,675,190420,6,9
600,513,1113,190420,6,10
714,592,1306,190420,6,11
733,613,1346,190420,6,12
602,592,1194,190420,6,13
488,533,1021,190420,6,14
493,581,1074,190420,6,15
392,548,940,190420,6,16
388,532,920,190420,6,17
394,470,864,190420,6,18
305,380,685,190420,6,19
249,264,513,190420,6,20
182,225,407,190420,6,21
137,162,299,190420,6,22
92,111,203,190420,6,23
72,76,148,190420,6,24
45,45,90,190421,7,1
27,30,57,190421,7,2
17,18,35,190421,7,3
14,12,26,190421,7,4
15,15,30,190421,7,5
50,42,92,190421,7,6
45,30,75,190421,7,7
63,73,136,190421,7,8
118,159,277,190421,7,9
302,345,647,190421,7,10
407,458,865,190421,7,11
474,450,924,190421,7,12
539,424,963,190421,7,13
565,384,949,190421,7,14
474,453,927,190421,7,15
492,490,982,190421,7,16
424,486,910,190421,7,17
457,526,983,190421,7,18
364,429,793,190421,7,19
283,294,577,190421,7,20
209,245,454,190421,7,21
152,154,306,190421,7,22
84,111,195,190421,7,23
50,33,83,190421,7,24
25,26,51,190422,1,1
28,25,53,190422,1,2
17,15,32,190422,1,3
9,16,25,190422,1,4
17,16,33,190422,1,5
49,55,104,190422,1,6
36,23,59,190422,1,7
72,80,152,190422,1,8
101,116,217,190422,1,9
228,259,487,190422,1,10
467,462,929,190422,1,11
576,514,1090,190422,1,12
520,486,1006,190422,1,13
594,527,1121,190422,1,14
608,633,1241,190422,1,15
473,650,1123,190422,1,16
415,601,1016,190422,1,17
480,561,1041,190422,1,18
346,403,749,190422,1,19
274,275,549,190422,1,20
193,190,383,190422,1,21
74,107,181,190422,1,22
44,69,113,190422,1,23
16,29,45,190422,1,24
5,15,20,190423,2,1
8,9,17,190423,2,2
10,11,21,190423,2,3
11,12,23,190423,2,4
47,37,84,190423,2,5
186,159,345,190423,2,6
542,398,940,190423,2,7
850,555,1405,190423,2,8
563,454,1017,190423,2,9
538,455,993,190423,2,10
510,496,1006,190423,2,11
508,515,1023,190423,2,12
528,547,1075,190423,2,13
620,669,1289,190423,2,14
580,553,1133,190423,2,15
595,663,1258,190423,2,16
727,756,1483,190423,2,17
589,689,1278,190423,2,18
393,535,928,190423,2,19
286,334,620,190423,2,20
184,194,378,190423,2,21
138,136,274,190423,2,22
81,102,183,190423,2,23
19,42,61,190423,2,24
16,27,43,190424,3,1
7,16,23,190424,3,2
11,15,26,190424,3,3
11,10,21,190424,3,4
50,30,80,190424,3,5
189,162,351,190424,3,6
526,397,923,190424,3,7
785,537,1322,190424,3,8
606,440,1046,190424,3,9
549,440,989,190424,3,10
560,523,1083,190424,3,11
579,591,1170,190424,3,12
512,610,1122,190424,3,13
584,665,1249,190424,3,14
522,607,1129,190424,3,15
629,695,1324,190424,3,16
742,732,1474,190424,3,17
565,652,1217,190424,3,18
419,513,932,190424,3,19
306,330,636,190424,3,20
218,251,469,190424,3,21
104,133,237,190424,3,22
66,92,158,190424,3,23
27,39,66,190424,3,24
18,25,43,190425,4,1
8,14,22,190425,4,2
11,18,29,190425,4,3
13,10,23,190425,4,4
54,32,86,190425,4,5
196,156,352,190425,4,6
504,376,880,190425,4,7
862,547,1409,190425,4,8
539,443,982,190425,4,9
558,488,1046,190425,4,10
530,545,1075,190425,4,11
593,542,1135,190425,4,12
546,578,1124,190425,4,13
595,617,1212,190425,4,14
575,597,1172,190425,4,15
708,708,1416,190425,4,16
754,773,1527,190425,4,17
564,685,1249,190425,4,18
447,562,1009,190425,4,19
252,366,618,190425,4,20
224,242,466,190425,4,21
131,185,316,190425,4,22
83,96,179,190425,4,23
40,76,116,190425,4,24
13,26,39,190426,5,1
7,10,17,190426,5,2
12,12,24,190426,5,3
10,12,22,190426,5,4
49,33,82,190426,5,5
180,146,326,190426,5,6
502,371,873,190426,5,7
745,472,1217,190426,5,8
585,472,1057,190426,5,9
600,503,1103,190426,5,10
552,564,1116,190426,5,11
601,574,1175,190426,5,12
632,667,1299,190426,5,13
619,701,1320,190426,5,14
680,656,1336,190426,5,15
638,634,1272,190426,5,16
601,611,1212,190426,5,17
517,517,1034,190426,5,18
433,494,927,190426,5,19
317,318,635,190426,5,20
203,224,427,190426,5,21
129,168,297,190426,5,22
84,120,204,190426,5,23
56,96,152,190426,5,24
30,38,68,190427,6,1
25,31,56,190427,6,2
13,19,32,190427,6,3
17,20,37,190427,6,4
26,24,50,190427,6,5
60,47,107,190427,6,6
95,85,180,190427,6,7
197,129,326,190427,6,8
335,243,578,190427,6,9
462,413,875,190427,6,10
588,493,1081,190427,6,11
546,513,1059,190427,6,12
527,505,1032,190427,6,13
470,520,990,190427,6,14
475,473,948,190427,6,15
367,409,776,190427,6,16
374,444,818,190427,6,17
373,401,774,190427,6,18
345,379,724,190427,6,19
223,283,506,190427,6,20
181,238,419,190427,6,21
125,219,344,190427,6,22
127,129,256,190427,6,23
98,94,192,190427,6,24
91,50,141,190428,7,1
103,62,165,190428,7,2
91,45,136,190428,7,3
42,37,79,190428,7,4
30,23,53,190428,7,5
48,43,91,190428,7,6
43,48,91,190428,7,7
81,80,161,190428,7,8
147,90,237,190428,7,9
264,237,501,190428,7,10
310,293,603,190428,7,11
344,362,706,190428,7,12
463,407,870,190428,7,13
426,423,849,190428,7,14
453,425,878,190428,7,15
417,459,876,190428,7,16
332,446,778,190428,7,17
386,405,791,190428,7,18
265,293,558,190428,7,19
184,228,412,190428,7,20
138,147,285,190428,7,21
81,117,198,190428,7,22
54,56,110,190428,7,23
26,53,79,190428,7,24
11,22,33,190429,1,1
10,15,25,190429,1,2
12,15,27,190429,1,3
13,9,22,190429,1,4
52,37,89,190429,1,5
197,162,359,190429,1,6
526,439,965,190429,1,7
861,531,1392,190429,1,8
605,472,1077,190429,1,9
543,494,1037,190429,1,10
577,545,1122,190429,1,11
548,572,1120,190429,1,12
545,583,1128,190429,1,13
550,536,1086,190429,1,14
553,583,1136,190429,1,15
660,695,1355,190429,1,16
749,767,1516,190429,1,17
537,620,1157,190429,1,18
432,559,991,190429,1,19
313,347,660,190429,1,20
189,215,404,190429,1,21
126,155,281,190429,1,22
75,88,163,190429,1,23
32,39,71,190429,1,24
13,21,34,190430,2,1
6,9,15,190430,2,2
9,7,16,190430,2,3
13,13,26,190430,2,4
48,33,81,190430,2,5
201,136,337,190430,2,6
493,381,874,190430,2,7
833,489,1322,190430,2,8
647,487,1134,190430,2,9
579,498,1077,190430,2,10
622,565,1187,190430,2,11
578,578,1156,190430,2,12
534,597,1131,190430,2,13
561,673,1234,190430,2,14
643,611,1254,190430,2,15
750,711,1461,190430,2,16
790,729,1519,190430,2,17
630,685,1315,190430,2,18
448,506,954,190430,2,19
353,408,761,190430,2,20
213,234,447,190430,2,21
156,192,348,190430,2,22
96,117,213,190430,2,23
68,84,152,190430,2,24
46,50,96,190501,3,1
36,39,75,190501,3,2
37,25,62,190501,3,3
26,26,52,190501,3,4
28,23,51,190501,3,5
56,51,107,190501,3,6
49,55,104,190501,3,7
71,64,135,190501,3,8
110,102,212,190501,3,9
207,200,407,190501,3,10
335,364,699,190501,3,11
355,417,772,190501,3,12
368,420,788,190501,3,13
380,428,808,190501,3,14
437,432,869,190501,3,15
371,383,754,190501,3,16
337,348,685,190501,3,17
392,320,712,190501,3,18
264,299,563,190501,3,19
220,206,426,190501,3,20
167,170,337,190501,3,21
92,92,184,190501,3,22
52,47,99,190501,3,23
34,37,71,190501,3,24
16,19,35,190502,4,1
12,10,22,190502,4,2
9,18,27,190502,4,3
13,11,24,190502,4,4
41,28,69,190502,4,5
202,123,325,190502,4,6
480,336,816,190502,4,7
791,513,1304,190502,4,8
611,490,1101,190502,4,9
616,478,1094,190502,4,10
535,536,1071,190502,4,11
505,578,1083,190502,4,12
554,567,1121,190502,4,13
532,582,1114,190502,4,14
573,623,1196,190502,4,15
606,669,1275,190502,4,16
677,697,1374,190502,4,17
522,652,1174,190502,4,18
424,537,961,190502,4,19
254,351,605,190502,4,20
197,224,421,190502,4,21
137,158,295,190502,4,22
82,76,158,190502,4,23
32,40,72,190502,4,24
17,21,38,190503,5,1
4,11,15,190503,5,2
8,22,30,190503,5,3
14,11,25,190503,5,4
45,31,76,190503,5,5
196,121,317,190503,5,6
457,318,775,190503,5,7
771,472,1243,190503,5,8
557,429,986,190503,5,9
534,485,1019,190503,5,10
599,562,1161,190503,5,11
582,612,1194,190503,5,12
651,676,1327,190503,5,13
611,634,1245,190503,5,14
611,644,1255,190503,5,15
605,601,1206,190503,5,16
588,632,1220,190503,5,17
483,527,1010,190503,5,18
430,456,886,190503,5,19
273,310,583,190503,5,20
174,189,363,190503,5,21
119,187,306,190503,5,22
77,126,203,190503,5,23
62,75,137,190503,5,24
26,34,60,190504,6,1
19,20,39,190504,6,2
19,19,38,190504,6,3
16,18,34,190504,6,4
20,20,40,190504,6,5
77,51,128,190504,6,6
74,61,135,190504,6,7
141,98,239,190504,6,8
303,232,535,190504,6,9
484,399,883,190504,6,10
541,467,1008,190504,6,11
546,537,1083,190504,6,12
573,547,1120,190504,6,13
404,542,946,190504,6,14
455,480,935,190504,6,15
407,409,816,190504,6,16
431,390,821,190504,6,17
371,407,778,190504,6,18
295,339,634,190504,6,19
215,234,449,190504,6,20
138,217,355,190504,6,21
137,143,280,190504,6,22
101,124,225,190504,6,23
78,83,161,190504,6,24
45,44,89,190505,7,1
37,38,75,190505,7,2
31,26,57,190505,7,3
15,26,41,190505,7,4
20,21,41,190505,7,5
50,34,84,190505,7,6
37,35,72,190505,7,7
64,77,141,190505,7,8
153,111,264,190505,7,9
317,247,564,190505,7,10
461,329,790,190505,7,11
556,447,1003,190505,7,12
520,458,978,190505,7,13
532,490,1022,190505,7,14
446,575,1021,190505,7,15
424,524,948,190505,7,16
377,569,946,190505,7,17
383,515,898,190505,7,18
275,317,592,190505,7,19
195,250,445,190505,7,20
151,150,301,190505,7,21
97,96,193,190505,7,22
53,75,128,190505,7,23
33,28,61,190505,7,24
10,22,32,190506,1,1
8,16,24,190506,1,2
6,9,15,190506,1,3
9,9,18,190506,1,4
56,39,95,190506,1,5
236,168,404,190506,1,6
552,421,973,190506,1,7
840,544,1384,190506,1,8
608,445,1053,190506,1,9
578,414,992,190506,1,10
531,550,1081,190506,1,11
512,533,1045,190506,1,12
493,558,1051,190506,1,13
516,545,1061,190506,1,14
537,501,1038,190506,1,15
602,679,1281,190506,1,16
737,602,1339,190506,1,17
552,662,1214,190506,1,18
386,537,923,190506,1,19
287,300,587,190506,1,20
151,181,332,190506,1,21
45,53,98,190506,1,22
65,89,154,190506,1,23
27,34,61,190506,1,24
10,17,27,190507,2,1
8,14,22,190507,2,2
14,11,25,190507,2,3
8,18,26,190507,2,4
45,38,83,190507,2,5
231,144,375,190507,2,6
541,423,964,190507,2,7
845,563,1408,190507,2,8
580,452,1032,190507,2,9
551,438,989,190507,2,10
490,478,968,190507,2,11
531,483,1014,190507,2,12
523,568,1091,190507,2,13
569,587,1156,190507,2,14
527,570,1097,190507,2,15
623,696,1319,190507,2,16
743,706,1449,190507,2,17
571,668,1239,190507,2,18
405,493,898,190507,2,19
272,318,590,190507,2,20
169,196,365,190507,2,21
140,151,291,190507,2,22
76,79,155,190507,2,23
25,38,63,190507,2,24
11,20,31,190508,3,1
11,19,30,190508,3,2
8,6,14,190508,3,3
8,12,20,190508,3,4
47,36,83,190508,3,5
212,154,366,190508,3,6
546,399,945,190508,3,7
842,549,1391,190508,3,8
606,458,1064,190508,3,9
545,476,1021,190508,3,10
508,464,972,190508,3,11
561,477,1038,190508,3,12
523,509,1032,190508,3,13
495,586,1081,190508,3,14
517,613,1130,190508,3,15
591,634,1225,190508,3,16
747,687,1434,190508,3,17
574,595,1169,190508,3,18
383,458,841,190508,3,19
250,290,540,190508,3,20
182,213,395,190508,3,21
106,164,270,190508,3,22
81,87,168,190508,3,23
29,38,67,190508,3,24
13,23,36,190509,4,1
6,14,20,190509,4,2
11,11,22,190509,4,3
13,17,30,190509,4,4
39,30,69,190509,4,5
244,154,398,190509,4,6
560,397,957,190509,4,7
822,540,1362,190509,4,8
596,436,1032,190509,4,9
545,494,1039,190509,4,10
511,520,1031,190509,4,11
493,509,1002,190509,4,12
485,547,1032,190509,4,13
563,581,1144,190509,4,14
552,585,1137,190509,4,15
663,643,1306,190509,4,16
731,704,1435,190509,4,17
603,590,1193,190509,4,18
374,566,940,190509,4,19
245,371,616,190509,4,20
208,253,461,190509,4,21
140,146,286,190509,4,22
90,97,187,190509,4,23
37,57,94,190509,4,24
15,17,32,190510,5,1
10,10,20,190510,5,2
7,10,17,190510,5,3
13,15,28,190510,5,4
45,30,75,190510,5,5
213,142,355,190510,5,6
532,382,914,190510,5,7
801,550,1351,190510,5,8
574,438,1012,190510,5,9
556,500,1056,190510,5,10
552,532,1084,190510,5,11
556,588,1144,190510,5,12
706,640,1346,190510,5,13
660,705,1365,190510,5,14
631,681,1312,190510,5,15
660,599,1259,190510,5,16
628,622,1250,190510,5,17
531,508,1039,190510,5,18
408,474,882,190510,5,19
288,312,600,190510,5,20
188,238,426,190510,5,21
79,87,166,190510,5,22
101,116,217,190510,5,23
61,71,132,190510,5,24
40,46,86,190511,6,1
20,26,46,190511,6,2
18,25,43,190511,6,3
18,16,34,190511,6,4
25,35,60,190511,6,5
65,53,118,190511,6,6
93,75,168,190511,6,7
204,154,358,190511,6,8
362,274,636,190511,6,9
537,416,953,190511,6,10
592,511,1103,190511,6,11
543,568,1111,190511,6,12
557,532,1089,190511,6,13
483,584,1067,190511,6,14
498,556,1054,190511,6,15
362,496,858,190511,6,16
434,479,913,190511,6,17
410,437,847,190511,6,18
377,372,749,190511,6,19
260,280,540,190511,6,20
174,216,390,190511,6,21
135,165,300,190511,6,22
84,126,210,190511,6,23
60,85,145,190511,6,24
43,59,102,190512,7,1
38,35,73,190512,7,2
24,29,53,190512,7,3
29,29,58,190512,7,4
23,27,50,190512,7,5
45,59,104,190512,7,6
42,44,86,190512,7,7
80,87,167,190512,7,8
169,144,313,190512,7,9
307,247,554,190512,7,10
410,391,801,190512,7,11
523,459,982,190512,7,12
558,530,1088,190512,7,13
603,484,1087,190512,7,14
525,556,1081,190512,7,15
414,578,992,190512,7,16
430,566,996,190512,7,17
487,567,1054,190512,7,18
358,501,859,190512,7,19
272,340,612,190512,7,20
209,222,431,190512,7,21
115,163,278,190512,7,22
69,75,144,190512,7,23
32,38,70,190512,7,24
16,26,42,190513,1,1
6,12,18,190513,1,2
6,15,21,190513,1,3
17,26,43,190513,1,4
70,44,114,190513,1,5
228,180,408,190513,1,6
570,453,1023,190513,1,7
882,541,1423,190513,1,8
671,414,1085,190513,1,9
573,452,1025,190513,1,10
565,569,1134,190513,1,11
568,510,1078,190513,1,12
560,592,1152,190513,1,13
515,601,1116,190513,1,14
591,613,1204,190513,1,15
631,731,1362,190513,1,16
754,697,1451,190513,1,17
605,722,1327,190513,1,18
441,500,941,190513,1,19
296,347,643,190513,1,20
199,205,404,190513,1,21
114,148,262,190513,1,22
66,91,157,190513,1,23
23,31,54,190513,1,24
12,14,26,190514,2,1
6,9,15,190514,2,2
13,7,20,190514,2,3
10,9,19,190514,2,4
51,38,89,190514,2,5
215,156,371,190514,2,6
582,438,1020,190514,2,7
894,545,1439,190514,2,8
607,455,1062,190514,2,9
563,487,1050,190514,2,10
560,533,1093,190514,2,11
506,518,1024,190514,2,12
527,586,1113,190514,2,13
546,624,1170,190514,2,14
574,592,1166,190514,2,15
623,713,1336,190514,2,16
799,732,1531,190514,2,17
597,638,1235,190514,2,18
402,473,875,190514,2,19
304,360,664,190514,2,20
201,211,412,190514,2,21
151,163,314,190514,2,22
76,99,175,190514,2,23
33,35,68,190514,2,24
9,19,28,190515,3,1
6,8,14,190515,3,2
12,6,18,190515,3,3
13,15,28,190515,3,4
54,36,90,190515,3,5
212,159,371,190515,3,6
594,411,1005,190515,3,7
856,458,1314,190515,3,8
620,448,1068,190515,3,9
556,438,994,190515,3,10
558,522,1080,190515,3,11
507,541,1048,190515,3,12
588,576,1164,190515,3,13
573,585,1158,190515,3,14
553,657,1210,190515,3,15
602,756,1358,190515,3,16
819,669,1488,190515,3,17
583,668,1251,190515,3,18
451,477,928,190515,3,19
290,343,633,190515,3,20
193,248,441,190515,3,21
140,183,323,190515,3,22
91,104,195,190515,3,23
30,41,71,190515,3,24
14,22,36,190516,4,1
14,14,28,190516,4,2
7,13,20,190516,4,3
9,11,20,190516,4,4
48,37,85,190516,4,5
215,144,359,190516,4,6
577,411,988,190516,4,7
856,542,1398,190516,4,8
608,458,1066,190516,4,9
603,462,1065,190516,4,10
558,505,1063,190516,4,11
542,538,1080,190516,4,12
549,588,1137,190516,4,13
568,621,1189,190516,4,14
627,573,1200,190516,4,15
632,661,1293,190516,4,16
851,714,1565,190516,4,17
595,680,1275,190516,4,18
419,692,1111,190516,4,19
295,473,768,190516,4,20
190,232,422,190516,4,21
127,159,286,190516,4,22
74,94,168,190516,4,23
41,50,91,190516,4,24
13,18,31,190517,5,1
6,8,14,190517,5,2
9,13,22,190517,5,3
10,14,24,190517,5,4
54,36,90,190517,5,5
217,129,346,190517,5,6
508,383,891,190517,5,7
842,516,1358,190517,5,8
560,453,1013,190517,5,9
508,456,964,190517,5,10
550,509,1059,190517,5,11
677,585,1262,190517,5,12
730,616,1346,190517,5,13
668,654,1322,190517,5,14
705,648,1353,190517,5,15
661,628,1289,190517,5,16
628,635,1263,190517,5,17
507,535,1042,190517,5,18
410,455,865,190517,5,19
318,326,644,190517,5,20
220,245,465,190517,5,21
143,191,334,190517,5,22
106,152,258,190517,5,23
74,72,146,190517,5,24
43,60,103,190518,6,1
25,32,57,190518,6,2
18,24,42,190518,6,3
17,15,32,190518,6,4
22,30,52,190518,6,5
59,32,91,190518,6,6
83,81,164,190518,6,7
147,134,281,190518,6,8
290,226,516,190518,6,9
463,400,863,190518,6,10
519,515,1034,190518,6,11
573,631,1204,190518,6,12
553,519,1072,190518,6,13
458,495,953,190518,6,14
481,449,930,190518,6,15
431,466,897,190518,6,16
421,409,830,190518,6,17
420,402,822,190518,6,18
347,377,724,190518,6,19
277,302,579,190518,6,20
183,224,407,190518,6,21
118,131,249,190518,6,22
95,111,206,190518,6,23
43,89,132,190518,6,24
52,71,123,190519,7,1
38,55,93,190519,7,2
23,29,52,190519,7,3
21,24,45,190519,7,4
20,23,43,190519,7,5
37,29,66,190519,7,6
35,51,86,190519,7,7
68,63,131,190519,7,8
122,133,255,190519,7,9
225,278,503,190519,7,10
339,391,730,190519,7,11
415,501,916,190519,7,12
515,454,969,190519,7,13
481,457,938,190519,7,14
529,510,1039,190519,7,15
516,500,1016,190519,7,16
488,512,1000,190519,7,17
470,526,996,190519,7,18
365,372,737,190519,7,19
256,268,524,190519,7,20
162,201,363,190519,7,21
104,129,233,190519,7,22
56,77,133,190519,7,23
18,49,67,190519,7,24
8,26,34,190520,1,1
5,13,18,190520,1,2
9,7,16,190520,1,3
10,15,25,190520,1,4
58,42,100,190520,1,5
229,181,410,190520,1,6
554,409,963,190520,1,7
871,584,1455,190520,1,8
623,454,1077,190520,1,9
542,487,1029,190520,1,10
537,563,1100,190520,1,11
562,590,1152,190520,1,12
521,582,1103,190520,1,13
533,556,1089,190520,1,14
554,632,1186,190520,1,15
616,703,1319,190520,1,16
689,793,1482,190520,1,17
531,658,1189,190520,1,18
389,482,871,190520,1,19
284,333,617,190520,1,20
184,221,405,190520,1,21
114,152,266,190520,1,22
71,69,140,190520,1,23
17,32,49,190520,1,24
9,15,24,190521,2,1
7,13,20,190521,2,2
4,6,10,190521,2,3
8,15,23,190521,2,4
57,31,88,190521,2,5
188,151,339,190521,2,6
561,396,957,190521,2,7
831,570,1401,190521,2,8
564,466,1030,190521,2,9
526,502,1028,190521,2,10
507,530,1037,190521,2,11
586,574,1160,190521,2,12
519,525,1044,190521,2,13
518,640,1158,190521,2,14
611,657,1268,190521,2,15
580,740,1320,190521,2,16
735,794,1529,190521,2,17
603,663,1266,190521,2,18
406,527,933,190521,2,19
262,324,586,190521,2,20
159,213,372,190521,2,21
157,165,322,190521,2,22
56,73,129,190521,2,23
24,24,48,190521,2,24
5,17,22,190522,3,1
12,10,22,190522,3,2
7,11,18,190522,3,3
7,13,20,190522,3,4
53,38,91,190522,3,5
206,161,367,190522,3,6
559,410,969,190522,3,7
822,556,1378,190522,3,8
604,499,1103,190522,3,9
554,480,1034,190522,3,10
506,536,1042,190522,3,11
533,572,1105,190522,3,12
504,574,1078,190522,3,13
555,582,1137,190522,3,14
598,606,1204,190522,3,15
605,711,1316,190522,3,16
758,848,1606,190522,3,17
508,678,1186,190522,3,18
419,496,915,190522,3,19
295,321,616,190522,3,20
191,202,393,190522,3,21
149,179,328,190522,3,22
81,99,180,190522,3,23
26,26,52,190522,3,24
25,17,42,190523,4,1
8,11,19,190523,4,2
8,3,11,190523,4,3
11,10,21,190523,4,4
45,37,82,190523,4,5
217,165,382,190523,4,6
570,396,966,190523,4,7
852,583,1435,190523,4,8
589,511,1100,190523,4,9
581,530,1111,190523,4,10
554,547,1101,190523,4,11
546,597,1143,190523,4,12
539,555,1094,190523,4,13
560,632,1192,190523,4,14
620,586,1206,190523,4,15
624,680,1304,190523,4,16
744,828,1572,190523,4,17
628,703,1331,190523,4,18
436,563,999,190523,4,19
292,372,664,190523,4,20
208,258,466,190523,4,21
141,154,295,190523,4,22
80,104,184,190523,4,23
41,47,88,190523,4,24
25,33,58,190524,5,1
7,11,18,190524,5,2
6,15,21,190524,5,3
7,17,24,190524,5,4
48,35,83,190524,5,5
203,155,358,190524,5,6
521,383,904,190524,5,7
787,545,1332,190524,5,8
643,508,1151,190524,5,9
557,565,1122,190524,5,10
609,644,1253,190524,5,11
648,764,1412,190524,5,12
698,813,1511,190524,5,13
684,855,1539,190524,5,14
751,801,1552,190524,5,15
705,774,1479,190524,5,16
688,729,1417,190524,5,17
607,659,1266,190524,5,18
508,608,1116,190524,5,19
352,457,809,190524,5,20
228,314,542,190524,5,21
152,222,374,190524,5,22
166,158,324,190524,5,23
80,186,266,190524,5,24
39,55,94,190525,6,1
21,33,54,190525,6,2
12,28,40,190525,6,3
22,20,42,190525,6,4
24,41,65,190525,6,5
67,74,141,190525,6,6
81,108,189,190525,6,7
182,301,483,190525,6,8
316,317,633,190525,6,9
469,510,979,190525,6,10
534,657,1191,190525,6,11
699,730,1429,190525,6,12
660,704,1364,190525,6,13
624,740,1364,190525,6,14
741,603,1344,190525,6,15
739,547,1286,190525,6,16
752,498,1250,190525,6,17
483,575,1058,190525,6,18
334,545,879,190525,6,19
274,503,777,190525,6,20
190,368,558,190525,6,21
112,234,346,190525,6,22
102,170,272,190525,6,23
74,127,201,190525,6,24
67,98,165,190526,7,1
53,66,119,190526,7,2
28,53,81,190526,7,3
26,34,60,190526,7,4
23,36,59,190526,7,5
49,56,105,190526,7,6
49,49,98,190526,7,7
58,74,132,190526,7,8
103,119,222,190526,7,9
211,238,449,190526,7,10
304,422,726,190526,7,11
377,477,854,190526,7,12
465,496,961,190526,7,13
437,491,928,190526,7,14
433,475,908,190526,7,15
416,435,851,190526,7,16
373,524,897,190526,7,17
376,463,839,190526,7,18
269,339,608,190526,7,19
191,244,435,190526,7,20
141,176,317,190526,7,21
70,116,186,190526,7,22
49,76,125,190526,7,23
19,49,68,190526,7,24
14,27,41,190527,1,1
5,14,19,190527,1,2
7,11,18,190527,1,3
8,20,28,190527,1,4
55,42,97,190527,1,5
219,195,414,190527,1,6
536,448,984,190527,1,7
839,533,1372,190527,1,8
609,452,1061,190527,1,9
576,490,1066,190527,1,10
530,582,1112,190527,1,11
541,540,1081,190527,1,12
496,589,1085,190527,1,13
509,588,1097,190527,1,14
555,560,1115,190527,1,15
632,693,1325,190527,1,16
724,793,1517,190527,1,17
532,659,1191,190527,1,18
412,490,902,190527,1,19
271,316,587,190527,1,20
197,198,395,190527,1,21
94,139,233,190527,1,22
62,98,160,190527,1,23
30,45,75,190527,1,24
21,22,43,190528,2,1
8,12,20,190528,2,2
13,9,22,190528,2,3
10,16,26,190528,2,4
41,38,79,190528,2,5
208,162,370,190528,2,6
537,385,922,190528,2,7
853,544,1397,190528,2,8
565,458,1023,190528,2,9
604,428,1032,190528,2,10
521,486,1007,190528,2,11
526,550,1076,190528,2,12
555,530,1085,190528,2,13
546,645,1191,190528,2,14
603,602,1205,190528,2,15
634,712,1346,190528,2,16
774,799,1573,190528,2,17
578,677,1255,190528,2,18
384,533,917,190528,2,19
286,334,620,190528,2,20
202,249,451,190528,2,21
121,148,269,190528,2,22
82,123,205,190528,2,23
20,34,54,190528,2,24
20,20,40,190529,3,1
13,14,27,190529,3,2
17,14,31,190529,3,3
10,10,20,190529,3,4
54,45,99,190529,3,5
202,138,340,190529,3,6
495,379,874,190529,3,7
782,555,1337,190529,3,8
649,459,1108,190529,3,9
600,530,1130,190529,3,10
596,559,1155,190529,3,11
589,631,1220,190529,3,12
587,649,1236,190529,3,13
627,645,1272,190529,3,14
594,651,1245,190529,3,15
697,744,1441,190529,3,16
729,747,1476,190529,3,17
669,688,1357,190529,3,18
494,545,1039,190529,3,19
350,385,735,190529,3,20
218,241,459,190529,3,21
128,219,347,190529,3,22
97,128,225,190529,3,23
75,76,151,190529,3,24
43,41,84,190530,4,1
38,26,64,190530,4,2
28,18,46,190530,4,3
22,9,31,190530,4,4
21,24,45,190530,4,5
39,38,77,190530,4,6
52,50,102,190530,4,7
62,72,134,190530,4,8
123,118,241,190530,4,9
267,196,463,190530,4,10
353,323,676,190530,4,11
399,370,769,190530,4,12
372,365,737,190530,4,13
421,378,799,190530,4,14
426,410,836,190530,4,15
333,332,665,190530,4,16
325,376,701,190530,4,17
303,380,683,190530,4,18
272,274,546,190530,4,19
241,181,422,190530,4,20
153,144,297,190530,4,21
93,130,223,190530,4,22
73,82,155,190530,4,23
47,45,92,190530,4,24
21,27,48,190531,5,1
22,22,44,190531,5,2
24,34,58,190531,5,3
14,17,31,190531,5,4
38,38,76,190531,5,5
93,82,175,190531,5,6
209,145,354,190531,5,7
337,230,567,190531,5,8
366,332,698,190531,5,9
544,448,992,190531,5,10
639,558,1197,190531,5,11
661,605,1266,190531,5,12
557,611,1168,190531,5,13
580,579,1159,190531,5,14
602,599,1201,190531,5,15
518,589,1107,190531,5,16
475,542,1017,190531,5,17
446,499,945,190531,5,18
348,474,822,190531,5,19
268,302,570,190531,5,20
209,227,436,190531,5,21
141,158,299,190531,5,22
106,92,198,190531,5,23
62,68,130,190531,5,24
41,50,91,190601,6,1
19,28,47,190601,6,2
18,13,31,190601,6,3
19,17,36,190601,6,4
20,19,39,190601,6,5
55,49,104,190601,6,6
79,67,146,190601,6,7
130,111,241,190601,6,8
297,246,543,190601,6,9
487,416,903,190601,6,10
565,497,1062,190601,6,11
545,548,1093,190601,6,12
585,507,1092,190601,6,13
532,508,1040,190601,6,14
572,509,1081,190601,6,15
466,477,943,190601,6,16
403,460,863,190601,6,17
366,430,796,190601,6,18
322,350,672,190601,6,19
230,299,529,190601,6,20
204,223,427,190601,6,21
147,148,295,190601,6,22
78,108,186,190601,6,23
77,86,163,190601,6,24
47,56,103,190602,7,1
39,39,78,190602,7,2
19,22,41,190602,7,3
29,27,56,190602,7,4
30,28,58,190602,7,5
65,59,124,190602,7,6
58,55,113,190602,7,7
80,67,147,190602,7,8
151,138,289,190602,7,9
289,279,568,190602,7,10
536,405,941,190602,7,11
588,486,1074,190602,7,12
692,538,1230,190602,7,13
604,565,1169,190602,7,14
488,558,1046,190602,7,15
461,628,1089,190602,7,16
360,713,1073,190602,7,17
478,614,1092,190602,7,18
306,589,895,190602,7,19
260,302,562,190602,7,20
212,224,436,190602,7,21
107,140,247,190602,7,22
70,72,142,190602,7,23
25,36,61,190602,7,24
21,30,51,190603,1,1
10,21,31,190603,1,2
10,8,18,190603,1,3
9,14,23,190603,1,4
57,42,99,190603,1,5
236,171,407,190603,1,6
525,441,966,190603,1,7
870,574,1444,190603,1,8
585,496,1081,190603,1,9
587,568,1155,190603,1,10
552,540,1092,190603,1,11
543,575,1118,190603,1,12
519,604,1123,190603,1,13
551,570,1121,190603,1,14
582,648,1230,190603,1,15
615,713,1328,190603,1,16
725,787,1512,190603,1,17
561,697,1258,190603,1,18
402,565,967,190603,1,19
297,338,635,190603,1,20
170,209,379,190603,1,21
130,162,292,190603,1,22
72,108,180,190603,1,23
33,37,70,190603,1,24
15,16,31,190604,2,1
7,11,18,190604,2,2
12,9,21,190604,2,3
13,13,26,190604,2,4
52,33,85,190604,2,5
239,170,409,190604,2,6
595,420,1015,190604,2,7
867,548,1415,190604,2,8
608,488,1096,190604,2,9
522,457,979,190604,2,10
597,522,1119,190604,2,11
549,554,1103,190604,2,12
617,574,1191,190604,2,13
575,625,1200,190604,2,14
619,649,1268,190604,2,15
612,754,1366,190604,2,16
783,780,1563,190604,2,17
623,756,1379,190604,2,18
444,576,1020,190604,2,19
322,373,695,190604,2,20
225,242,467,190604,2,21
179,222,401,190604,2,22
100,124,224,190604,2,23
31,45,76,190604,2,24
20,32,52,190605,3,1
13,15,28,190605,3,2
7,11,18,190605,3,3
7,15,22,190605,3,4
55,35,90,190605,3,5
218,167,385,190605,3,6
586,412,998,190605,3,7
872,562,1434,190605,3,8
614,469,1083,190605,3,9
554,482,1036,190605,3,10
542,520,1062,190605,3,11
543,563,1106,190605,3,12
591,599,1190,190605,3,13
515,646,1161,190605,3,14
598,605,1203,190605,3,15
652,683,1335,190605,3,16
734,780,1514,190605,3,17
557,688,1245,190605,3,18
425,512,937,190605,3,19
290,351,641,190605,3,20
222,245,467,190605,3,21
141,182,323,190605,3,22
90,112,202,190605,3,23
27,47,74,190605,3,24
39,20,59,190606,4,1
13,17,30,190606,4,2
10,14,24,190606,4,3
9,14,23,190606,4,4
49,32,81,190606,4,5
229,155,384,190606,4,6
590,397,987,190606,4,7
864,560,1424,190606,4,8
672,476,1148,190606,4,9
587,526,1113,190606,4,10
596,532,1128,190606,4,11
536,631,1167,190606,4,12
561,621,1182,190606,4,13
569,630,1199,190606,4,14
637,644,1281,190606,4,15
711,740,1451,190606,4,16
836,794,1630,190606,4,17
624,714,1338,190606,4,18
469,579,1048,190606,4,19
299,362,661,190606,4,20
207,244,451,190606,4,21
144,179,323,190606,4,22
92,157,249,190606,4,23
40,50,90,190606,4,24
16,32,48,190607,5,1
8,9,17,190607,5,2
12,7,19,190607,5,3
10,14,24,190607,5,4
48,37,85,190607,5,5
219,156,375,190607,5,6
558,380,938,190607,5,7
796,546,1342,190607,5,8
620,490,1110,190607,5,9
613,527,1140,190607,5,10
632,550,1182,190607,5,11
655,619,1274,190607,5,12
757,750,1507,190607,5,13
706,804,1510,190607,5,14
738,658,1396,190607,5,15
707,653,1360,190607,5,16
623,588,1211,190607,5,17
557,592,1149,190607,5,18
449,569,1018,190607,5,19
308,384,692,190607,5,20
198,269,467,190607,5,21
166,196,362,190607,5,22
105,146,251,190607,5,23
66,88,154,190607,5,24
34,59,93,190608,6,1
31,35,66,190608,6,2
24,30,54,190608,6,3
11,18,29,190608,6,4
16,30,46,190608,6,5
76,59,135,190608,6,6
80,79,159,190608,6,7
140,122,262,190608,6,8
327,284,611,190608,6,9
499,410,909,190608,6,10
520,478,998,190608,6,11
557,536,1093,190608,6,12
526,517,1043,190608,6,13
497,543,1040,190608,6,14
480,526,1006,190608,6,15
424,426,850,190608,6,16
376,422,798,190608,6,17
391,389,780,190608,6,18
321,375,696,190608,6,19
239,261,500,190608,6,20
166,201,367,190608,6,21
122,166,288,190608,6,22
90,135,225,190608,6,23
67,133,200,190608,6,24
76,66,142,190609,7,1
60,43,103,190609,7,2
25,27,52,190609,7,3
20,28,48,190609,7,4
20,16,36,190609,7,5
54,48,102,190609,7,6
35,43,78,190609,7,7
67,64,131,190609,7,8
124,96,220,190609,7,9
315,260,575,190609,7,10
390,347,737,190609,7,11
539,447,986,190609,7,12
608,434,1042,190609,7,13
557,470,1027,190609,7,14
545,516,1061,190609,7,15
511,560,1071,190609,7,16
434,542,976,190609,7,17
395,496,891,190609,7,18
354,400,754,190609,7,19
298,371,669,190609,7,20
218,237,455,190609,7,21
184,161,345,190609,7,22
103,115,218,190609,7,23
70,214,284,190609,7,24
41,77,118,190610,1,1
24,39,63,190610,1,2
13,20,33,190610,1,3
13,23,36,190610,1,4
23,20,43,190610,1,5
36,37,73,190610,1,6
44,53,97,190610,1,7
57,62,119,190610,1,8
116,88,204,190610,1,9
207,217,424,190610,1,10
341,345,686,190610,1,11
416,491,907,190610,1,12
455,461,916,190610,1,13
508,496,1004,190610,1,14
563,542,1105,190610,1,15
501,515,1016,190610,1,16
413,516,929,190610,1,17
391,468,859,190610,1,18
313,358,671,190610,1,19
234,271,505,190610,1,20
168,195,363,190610,1,21
109,105,214,190610,1,22
62,78,140,190610,1,23
36,40,76,190610,1,24
13,29,42,190611,2,1
8,21,29,190611,2,2
5,10,15,190611,2,3
9,18,27,190611,2,4
52,29,81,190611,2,5
218,170,388,190611,2,6
592,444,1036,190611,2,7
835,533,1368,190611,2,8
622,467,1089,190611,2,9
512,472,984,190611,2,10
577,519,1096,190611,2,11
548,594,1142,190611,2,12
543,652,1195,190611,2,13
565,602,1167,190611,2,14
606,622,1228,190611,2,15
615,734,1349,190611,2,16
768,778,1546,190611,2,17
615,733,1348,190611,2,18
473,594,1067,190611,2,19
294,344,638,190611,2,20
193,210,403,190611,2,21
129,141,270,190611,2,22
80,113,193,190611,2,23
26,46,72,190611,2,24
16,18,34,190612,3,1
15,15,30,190612,3,2
10,10,20,190612,3,3
8,14,22,190612,3,4
52,35,87,190612,3,5
215,147,362,190612,3,6
524,393,917,190612,3,7
857,534,1391,190612,3,8
603,471,1074,190612,3,9
552,489,1041,190612,3,10
604,526,1130,190612,3,11
553,602,1155,190612,3,12
534,641,1175,190612,3,13
531,613,1144,190612,3,14
617,638,1255,190612,3,15
578,704,1282,190612,3,16
742,741,1483,190612,3,17
591,693,1284,190612,3,18
418,472,890,190612,3,19
265,315,580,190612,3,20
173,202,375,190612,3,21
118,151,269,190612,3,22
87,124,211,190612,3,23
35,36,71,190612,3,24
26,24,50,190613,4,1
9,15,24,190613,4,2
6,13,19,190613,4,3
14,17,31,190613,4,4
49,40,89,190613,4,5
229,165,394,190613,4,6
533,392,925,190613,4,7
852,548,1400,190613,4,8
649,518,1167,190613,4,9
602,508,1110,190613,4,10
616,547,1163,190613,4,11
566,582,1148,190613,4,12
567,629,1196,190613,4,13
608,632,1240,190613,4,14
648,611,1259,190613,4,15
671,763,1434,190613,4,16
725,739,1464,190613,4,17
617,743,1360,190613,4,18
453,560,1013,190613,4,19
322,353,675,190613,4,20
241,266,507,190613,4,21
179,249,428,190613,4,22
109,152,261,190613,4,23
38,58,96,190613,4,24
19,20,39,190614,5,1
12,10,22,190614,5,2
13,11,24,190614,5,3
8,10,18,190614,5,4
49,28,77,190614,5,5
238,140,378,190614,5,6
530,366,896,190614,5,7
763,507,1270,190614,5,8
615,484,1099,190614,5,9
667,552,1219,190614,5,10
626,574,1200,190614,5,11
721,674,1395,190614,5,12
738,741,1479,190614,5,13
743,780,1523,190614,5,14
680,717,1397,190614,5,15
628,627,1255,190614,5,16
671,665,1336,190614,5,17
616,629,1245,190614,5,18
448,535,983,190614,5,19
338,369,707,190614,5,20
232,275,507,190614,5,21
179,189,368,190614,5,22
135,143,278,190614,5,23
107,94,201,190614,5,24
55,58,113,190615,6,1
28,40,68,190615,6,2
28,21,49,190615,6,3
17,38,55,190615,6,4
35,32,67,190615,6,5
105,83,188,190615,6,6
98,105,203,190615,6,7
181,147,328,190615,6,8
320,271,591,190615,6,9
468,444,912,190615,6,10
496,499,995,190615,6,11
507,553,1060,190615,6,12
566,579,1145,190615,6,13
523,528,1051,190615,6,14
501,499,1000,190615,6,15
458,453,911,190615,6,16
458,416,874,190615,6,17
470,336,806,190615,6,18
344,364,708,190615,6,19
258,268,526,190615,6,20
208,222,430,190615,6,21
154,179,333,190615,6,22
109,134,243,190615,6,23
90,102,192,190615,6,24
66,66,132,190616,7,1
59,48,107,190616,7,2
23,37,60,190616,7,3
26,29,55,190616,7,4
29,29,58,190616,7,5
65,48,113,190616,7,6
44,40,84,190616,7,7
105,59,164,190616,7,8
146,126,272,190616,7,9
316,242,558,190616,7,10
408,380,788,190616,7,11
498,424,922,190616,7,12
577,447,1024,190616,7,13
550,455,1005,190616,7,14
552,522,1074,190616,7,15
501,539,1040,190616,7,16
432,540,972,190616,7,17
416,584,1000,190616,7,18
383,397,780,190616,7,19
240,279,519,190616,7,20
192,204,396,190616,7,21
108,115,223,190616,7,22
53,85,138,190616,7,23
43,51,94,190616,7,24
18,23,41,190617,1,1
7,14,21,190617,1,2
11,21,32,190617,1,3
11,22,33,190617,1,4
54,41,95,190617,1,5
237,156,393,190617,1,6
601,426,1027,190617,1,7
895,542,1437,190617,1,8
694,484,1178,190617,1,9
643,530,1173,190617,1,10
608,589,1197,190617,1,11
557,614,1171,190617,1,12
616,570,1186,190617,1,13
591,677,1268,190617,1,14
594,616,1210,190617,1,15
608,719,1327,190617,1,16
793,884,1677,190617,1,17
635,736,1371,190617,1,18
468,607,1075,190617,1,19
338,376,714,190617,1,20
197,246,443,190617,1,21
139,195,334,190617,1,22
91,98,189,190617,1,23
33,41,74,190617,1,24
27,27,54,190618,2,1
8,13,21,190618,2,2
11,23,34,190618,2,3
17,10,27,190618,2,4
51,35,86,190618,2,5
222,164,386,190618,2,6
582,397,979,190618,2,7
901,533,1434,190618,2,8
645,492,1137,190618,2,9
572,508,1080,190618,2,10
565,567,1132,190618,2,11
562,516,1078,190618,2,12
562,610,1172,190618,2,13
589,624,1213,190618,2,14
674,712,1386,190618,2,15
678,755,1433,190618,2,16
855,823,1678,190618,2,17
581,740,1321,190618,2,18
443,527,970,190618,2,19
304,320,624,190618,2,20
205,227,432,190618,2,21
133,189,322,190618,2,22
87,160,247,190618,2,23
25,53,78,190618,2,24
21,19,40,190619,3,1
9,17,26,190619,3,2
8,20,28,190619,3,3
14,18,32,190619,3,4
55,40,95,190619,3,5
247,174,421,190619,3,6
594,400,994,190619,3,7
891,548,1439,190619,3,8
642,503,1145,190619,3,9
636,468,1104,190619,3,10
558,530,1088,190619,3,11
578,580,1158,190619,3,12
611,641,1252,190619,3,13
580,621,1201,190619,3,14
589,674,1263,190619,3,15
683,739,1422,190619,3,16
813,739,1552,190619,3,17
595,645,1240,190619,3,18
454,531,985,190619,3,19
361,407,768,190619,3,20
208,242,450,190619,3,21
123,197,320,190619,3,22
88,111,199,190619,3,23
55,46,101,190619,3,24
23,25,48,190620,4,1
19,15,34,190620,4,2
8,15,23,190620,4,3
12,15,27,190620,4,4
53,32,85,190620,4,5
236,163,399,190620,4,6
633,418,1051,190620,4,7
915,557,1472,190620,4,8
651,531,1182,190620,4,9
636,516,1152,190620,4,10
583,614,1197,190620,4,11
581,616,1197,190620,4,12
616,707,1323,190620,4,13
605,653,1258,190620,4,14
651,666,1317,190620,4,15
696,688,1384,190620,4,16
811,852,1663,190620,4,17
662,724,1386,190620,4,18
483,643,1126,190620,4,19
344,398,742,190620,4,20
236,287,523,190620,4,21
167,193,360,190620,4,22
100,144,244,190620,4,23
46,52,98,190620,4,24
20,22,42,190621,5,1
10,16,26,190621,5,2
7,11,18,190621,5,3
10,18,28,190621,5,4
55,35,90,190621,5,5
206,162,368,190621,5,6
508,342,850,190621,5,7
825,537,1362,190621,5,8
566,457,1023,190621,5,9
627,498,1125,190621,5,10
587,621,1208,190621,5,11
629,612,1241,190621,5,12
713,744,1457,190621,5,13
713,727,1440,190621,5,14
653,745,1398,190621,5,15
663,666,1329,190621,5,16
663,669,1332,190621,5,17
559,581,1140,190621,5,18
437,498,935,190621,5,19
342,363,705,190621,5,20
210,239,449,190621,5,21
154,185,339,190621,5,22
119,204,323,190621,5,23
97,125,222,190621,5,24
50,97,147,190622,6,1
40,50,90,190622,6,2
23,30,53,190622,6,3
17,27,44,190622,6,4
28,36,64,190622,6,5
80,53,133,190622,6,6
88,84,172,190622,6,7
186,138,324,190622,6,8
293,275,568,190622,6,9
521,389,910,190622,6,10
572,414,986,190622,6,11
564,439,1003,190622,6,12
572,412,984,190622,6,13
512,472,984,190622,6,14
507,493,1000,190622,6,15
389,455,844,190622,6,16
360,472,832,190622,6,17
396,501,897,190622,6,18
420,418,838,190622,6,19
305,330,635,190622,6,20
201,225,426,190622,6,21
152,208,360,190622,6,22
130,196,326,190622,6,23
95,183,278,190622,6,24
91,127,218,190623,7,1
72,86,158,190623,7,2
38,35,73,190623,7,3
34,27,61,190623,7,4
29,42,71,190623,7,5
61,52,113,190623,7,6
51,58,109,190623,7,7
64,66,130,190623,7,8
176,159,335,190623,7,9
340,245,585,190623,7,10
414,328,742,190623,7,11
556,430,986,190623,7,12
556,382,938,190623,7,13
556,444,1000,190623,7,14
492,503,995,190623,7,15
446,551,997,190623,7,16
401,599,1000,190623,7,17
398,541,939,190623,7,18
332,424,756,190623,7,19
250,308,558,190623,7,20
161,244,405,190623,7,21
153,172,325,190623,7,22
55,126,181,190623,7,23
36,72,108,190623,7,24
15,41,56,190624,1,1
7,12,19,190624,1,2
12,20,32,190624,1,3
14,19,33,190624,1,4
49,34,83,190624,1,5
217,177,394,190624,1,6
555,409,964,190624,1,7
821,527,1348,190624,1,8
654,537,1191,190624,1,9
585,527,1112,190624,1,10
644,612,1256,190624,1,11
647,594,1241,190624,1,12
590,613,1203,190624,1,13
590,603,1193,190624,1,14
569,581,1150,190624,1,15
710,716,1426,190624,1,16
790,811,1601,190624,1,17
586,677,1263,190624,1,18
432,606,1038,190624,1,19
287,362,649,190624,1,20
230,261,491,190624,1,21
44,63,107,190624,1,22
42,65,107,190624,1,23
33,44,77,190624,1,24
15,26,41,190625,2,1
11,16,27,190625,2,2
9,14,23,190625,2,3
11,14,25,190625,2,4
51,36,87,190625,2,5
240,153,393,190625,2,6
595,408,1003,190625,2,7
878,572,1450,190625,2,8
637,527,1164,190625,2,9
692,508,1200,190625,2,10
606,492,1098,190625,2,11
590,554,1144,190625,2,12
666,596,1262,190625,2,13
686,622,1308,190625,2,14
676,624,1300,190625,2,15
720,693,1413,190625,2,16
754,829,1583,190625,2,17
664,706,1370,190625,2,18
464,626,1090,190625,2,19
320,398,718,190625,2,20
205,278,483,190625,2,21
139,226,365,190625,2,22
101,147,248,190625,2,23
53,84,137,190625,2,24
21,28,49,190626,3,1
10,24,34,190626,3,2
6,8,14,190626,3,3
17,13,30,190626,3,4
53,44,97,190626,3,5
228,149,377,190626,3,6
571,392,963,190626,3,7
880,571,1451,190626,3,8
683,483,1166,190626,3,9
671,501,1172,190626,3,10
604,540,1144,190626,3,11
679,636,1315,190626,3,12
590,601,1191,190626,3,13
630,615,1245,190626,3,14
613,650,1263,190626,3,15
680,718,1398,190626,3,16
752,796,1548,190626,3,17
599,729,1328,190626,3,18
473,647,1120,190626,3,19
354,424,778,190626,3,20
211,316,527,190626,3,21
173,246,419,190626,3,22
85,145,230,190626,3,23
31,74,105,190626,3,24
29,38,67,190627,4,1
14,28,42,190627,4,2
17,16,33,190627,4,3
15,14,29,190627,4,4
48,51,99,190627,4,5
222,166,388,190627,4,6
563,385,948,190627,4,7
881,537,1418,190627,4,8
715,519,1234,190627,4,9
601,560,1161,190627,4,10
619,603,1222,190627,4,11
616,645,1261,190627,4,12
609,663,1272,190627,4,13
610,642,1252,190627,4,14
644,603,1247,190627,4,15
729,741,1470,190627,4,16
845,665,1510,190627,4,17
670,698,1368,190627,4,18
489,607,1096,190627,4,19
340,411,751,190627,4,20
240,276,516,190627,4,21
161,228,389,190627,4,22
108,196,304,190627,4,23
86,103,189,190627,4,24
24,46,70,190628,5,1
17,26,43,190628,5,2
19,24,43,190628,5,3
27,35,62,190628,5,4
63,49,112,190628,5,5
210,153,363,190628,5,6
512,355,867,190628,5,7
856,511,1367,190628,5,8
574,465,1039,190628,5,9
557,477,1034,190628,5,10
601,536,1137,190628,5,11
657,610,1267,190628,5,12
756,803,1559,190628,5,13
687,659,1346,190628,5,14
711,697,1408,190628,5,15
710,602,1312,190628,5,16
661,651,1312,190628,5,17
594,553,1147,190628,5,18
445,518,963,190628,5,19
308,410,718,190628,5,20
270,257,527,190628,5,21
139,226,365,190628,5,22
117,148,265,190628,5,23
73,113,186,190628,5,24
51,125,176,190629,6,1
49,60,109,190629,6,2
19,30,49,190629,6,3
21,25,46,190629,6,4
30,23,53,190629,6,5
82,54,136,190629,6,6
85,95,180,190629,6,7
209,141,350,190629,6,8
331,250,581,190629,6,9
566,383,949,190629,6,10
650,590,1240,190629,6,11
665,617,1282,190629,6,12
621,615,1236,190629,6,13
601,649,1250,190629,6,14
575,603,1178,190629,6,15
502,556,1058,190629,6,16
466,558,1024,190629,6,17
441,499,940,190629,6,18
349,452,801,190629,6,19
275,355,630,190629,6,20
220,272,492,190629,6,21
156,205,361,190629,6,22
108,188,296,190629,6,23
84,144,228,190629,6,24
74,127,201,190630,7,1
58,80,138,190630,7,2
42,47,89,190630,7,3
27,30,57,190630,7,4
25,29,54,190630,7,5
68,67,135,190630,7,6
75,70,145,190630,7,7
69,76,145,190630,7,8
173,151,324,190630,7,9
342,261,603,190630,7,10
561,335,896,190630,7,11
676,399,1075,190630,7,12
630,427,1057,190630,7,13
591,457,1048,190630,7,14
496,496,992,190630,7,15
391,547,938,190630,7,16
423,609,1032,190630,7,17
423,604,1027,190630,7,18
361,564,925,190630,7,19
294,415,709,190630,7,20
217,290,507,190630,7,21
141,158,299,190630,7,22
67,101,168,190630,7,23
23,54,77,190630,7,24
25,100,125,190701,1,1
19,58,77,190701,1,2
13,14,27,190701,1,3
13,9,22,190701,1,4
49,49,98,190701,1,5
221,179,400,190701,1,6
570,400,970,190701,1,7
671,450,1121,190701,1,8
624,458,1082,190701,1,9
636,523,1159,190701,1,10
628,620,1248,190701,1,11
600,583,1183,190701,1,12
557,563,1120,190701,1,13
554,616,1170,190701,1,14
570,604,1174,190701,1,15
663,686,1349,190701,1,16
833,768,1601,190701,1,17
575,696,1271,190701,1,18
431,520,951,190701,1,19
293,334,627,190701,1,20
194,226,420,190701,1,21
108,143,251,190701,1,22
88,79,167,190701,1,23
31,52,83,190701,1,24
11,24,35,190702,2,1
9,9,18,190702,2,2
8,14,22,190702,2,3
14,13,27,190702,2,4
47,37,84,190702,2,5
220,150,370,190702,2,6
524,365,889,190702,2,7
655,455,1110,190702,2,8
578,458,1036,190702,2,9
616,506,1122,190702,2,10
647,552,1199,190702,2,11
648,537,1185,190702,2,12
548,611,1159,190702,2,13
546,623,1169,190702,2,14
643,613,1256,190702,2,15
692,658,1350,190702,2,16
785,790,1575,190702,2,17
638,733,1371,190702,2,18
486,600,1086,190702,2,19
339,397,736,190702,2,20
197,251,448,190702,2,21
161,153,314,190702,2,22
82,112,194,190702,2,23
45,62,107,190702,2,24
33,28,61,190703,3,1
19,16,35,190703,3,2
6,10,16,190703,3,3
14,14,28,190703,3,4
58,49,107,190703,3,5
219,161,380,190703,3,6
577,366,943,190703,3,7
713,429,1142,190703,3,8
568,411,979,190703,3,9
630,462,1092,190703,3,10
645,591,1236,190703,3,11
608,623,1231,190703,3,12
616,599,1215,190703,3,13
600,646,1246,190703,3,14
606,636,1242,190703,3,15
653,721,1374,190703,3,16
800,815,1615,190703,3,17
622,690,1312,190703,3,18
428,553,981,190703,3,19
366,386,752,190703,3,20
217,259,476,190703,3,21
118,188,306,190703,3,22
98,103,201,190703,3,23
35,43,78,190703,3,24
23,23,46,190704,4,1
19,10,29,190704,4,2
12,18,30,190704,4,3
19,19,38,190704,4,4
50,41,91,190704,4,5
224,155,379,190704,4,6
565,362,927,190704,4,7
759,416,1175,190704,4,8
589,454,1043,190704,4,9
607,524,1131,190704,4,10
609,567,1176,190704,4,11
592,579,1171,190704,4,12
572,566,1138,190704,4,13
608,635,1243,190704,4,14
669,631,1300,190704,4,15
657,679,1336,190704,4,16
829,784,1613,190704,4,17
631,690,1321,190704,4,18
472,566,1038,190704,4,19
285,358,643,190704,4,20
219,265,484,190704,4,21
145,213,358,190704,4,22
73,108,181,190704,4,23
32,57,89,190704,4,24
19,23,42,190705,5,1
14,14,28,190705,5,2
10,8,18,190705,5,3
14,16,30,190705,5,4
49,41,90,190705,5,5
217,155,372,190705,5,6
525,333,858,190705,5,7
659,419,1078,190705,5,8
631,432,1063,190705,5,9
606,488,1094,190705,5,10
634,532,1166,190705,5,11
693,650,1343,190705,5,12
682,627,1309,190705,5,13
682,718,1400,190705,5,14
676,631,1307,190705,5,15
663,600,1263,190705,5,16
662,592,1254,190705,5,17
564,506,1070,190705,5,18
463,478,941,190705,5,19
292,325,617,190705,5,20
234,209,443,190705,5,21
115,167,282,190705,5,22
100,135,235,190705,5,23
68,90,158,190705,5,24
32,41,73,190706,6,1
28,21,49,190706,6,2
27,23,50,190706,6,3
18,18,36,190706,6,4
24,31,55,190706,6,5
64,50,114,190706,6,6
89,82,171,190706,6,7
144,125,269,190706,6,8
284,234,518,190706,6,9
443,384,827,190706,6,10
513,493,1006,190706,6,11
585,551,1136,190706,6,12
524,552,1076,190706,6,13
520,581,1101,190706,6,14
569,481,1050,190706,6,15
496,460,956,190706,6,16
450,469,919,190706,6,17
492,414,906,190706,6,18
380,377,757,190706,6,19
267,258,525,190706,6,20
169,202,371,190706,6,21
145,157,302,190706,6,22
123,257,380,190706,6,23
87,257,344,190706,6,24
62,79,141,190707,7,1
56,54,110,190707,7,2
31,44,75,190707,7,3
22,28,50,190707,7,4
30,35,65,190707,7,5
66,55,121,190707,7,6
54,51,105,190707,7,7
82,75,157,190707,7,8
165,108,273,190707,7,9
336,246,582,190707,7,10
489,388,877,190707,7,11
578,506,1084,190707,7,12
624,565,1189,190707,7,13
588,576,1164,190707,7,14
614,588,1202,190707,7,15
521,584,1105,190707,7,16
466,644,1110,190707,7,17
412,545,957,190707,7,18
314,340,654,190707,7,19
225,280,505,190707,7,20
170,189,359,190707,7,21
109,131,240,190707,7,22
69,89,158,190707,7,23
31,48,79,190707,7,24
12,23,35,190708,1,1
8,12,20,190708,1,2
8,12,20,190708,1,3
14,13,27,190708,1,4
40,48,88,190708,1,5
219,163,382,190708,1,6
514,363,877,190708,1,7
626,426,1052,190708,1,8
558,380,938,190708,1,9
576,450,1026,190708,1,10
626,608,1234,190708,1,11
579,599,1178,190708,1,12
545,562,1107,190708,1,13
518,576,1094,190708,1,14
586,612,1198,190708,1,15
683,699,1382,190708,1,16
732,781,1513,190708,1,17
599,698,1297,190708,1,18
444,518,962,190708,1,19
301,324,625,190708,1,20
192,215,407,190708,1,21
108,140,248,190708,1,22
80,108,188,190708,1,23
35,49,84,190708,1,24
20,28,48,190709,2,1
11,10,21,190709,2,2
13,12,25,190709,2,3
10,14,24,190709,2,4
44,42,86,190709,2,5
187,145,332,190709,2,6
512,361,873,190709,2,7
592,427,1019,190709,2,8
504,463,967,190709,2,9
596,499,1095,190709,2,10
624,600,1224,190709,2,11
595,574,1169,190709,2,12
578,595,1173,190709,2,13
563,561,1124,190709,2,14
685,622,1307,190709,2,15
673,702,1375,190709,2,16
753,759,1512,190709,2,17
604,699,1303,190709,2,18
391,512,903,190709,2,19
304,346,650,190709,2,20
206,241,447,190709,2,21
154,148,302,190709,2,22
88,95,183,190709,2,23
55,54,109,190709,2,24
20,23,43,190710,3,1
8,14,22,190710,3,2
7,9,16,190710,3,3
9,8,17,190710,3,4
50,38,88,190710,3,5
179,152,331,190710,3,6
466,349,815,190710,3,7
603,437,1040,190710,3,8
530,397,927,190710,3,9
620,463,1083,190710,3,10
585,584,1169,190710,3,11
598,583,1181,190710,3,12
559,552,1111,190710,3,13
579,661,1240,190710,3,14
578,574,1152,190710,3,15
628,659,1287,190710,3,16
775,792,1567,190710,3,17
568,643,1211,190710,3,18
439,531,970,190710,3,19
337,393,730,190710,3,20
200,244,444,190710,3,21
179,211,390,190710,3,22
101,166,267,190710,3,23
45,50,95,190710,3,24
18,25,43,190711,4,1
15,13,28,190711,4,2
8,16,24,190711,4,3
11,14,25,190711,4,4
42,45,87,190711,4,5
186,142,328,190711,4,6
476,357,833,190711,4,7
618,407,1025,190711,4,8
552,435,987,190711,4,9
556,530,1086,190711,4,10
588,602,1190,190711,4,11
572,652,1224,190711,4,12
563,600,1163,190711,4,13
575,636,1211,190711,4,14
603,590,1193,190711,4,15
656,677,1333,190711,4,16
765,704,1469,190711,4,17
556,598,1154,190711,4,18
422,522,944,190711,4,19
287,372,659,190711,4,20
192,230,422,190711,4,21
138,171,309,190711,4,22
92,105,197,190711,4,23
39,44,83,190711,4,24
24,20,44,190712,5,1
12,13,25,190712,5,2
9,8,17,190712,5,3
10,12,22,190712,5,4
36,32,68,190712,5,5
174,140,314,190712,5,6
458,323,781,190712,5,7
576,394,970,190712,5,8
496,383,879,190712,5,9
525,451,976,190712,5,10
552,516,1068,190712,5,11
650,670,1320,190712,5,12
698,601,1299,190712,5,13
574,599,1173,190712,5,14
622,545,1167,190712,5,15
575,525,1100,190712,5,16
607,549,1156,190712,5,17
501,477,978,190712,5,18
391,439,830,190712,5,19
277,304,581,190712,5,20
189,237,426,190712,5,21
131,177,308,190712,5,22
122,126,248,190712,5,23
59,91,150,190712,5,24
43,49,92,190713,6,1
18,31,49,190713,6,2
22,19,41,190713,6,3
11,14,25,190713,6,4
28,23,51,190713,6,5
80,47,127,190713,6,6
83,82,165,190713,6,7
158,103,261,190713,6,8
281,235,516,190713,6,9
502,392,894,190713,6,10
615,588,1203,190713,6,11
605,556,1161,190713,6,12
575,532,1107,190713,6,13
492,438,930,190713,6,14
526,557,1083,190713,6,15
438,491,929,190713,6,16
432,484,916,190713,6,17
439,438,877,190713,6,18
301,361,662,190713,6,19
250,301,551,190713,6,20
173,213,386,190713,6,21
133,163,296,190713,6,22
87,109,196,190713,6,23
74,96,170,190713,6,24
48,70,118,190714,7,1
45,42,87,190714,7,2
15,25,40,190714,7,3
20,23,43,190714,7,4
32,25,57,190714,7,5
55,51,106,190714,7,6
42,49,91,190714,7,7
46,66,112,190714,7,8
128,104,232,190714,7,9
256,205,461,190714,7,10
389,320,709,190714,7,11
469,467,936,190714,7,12
489,392,881,190714,7,13
460,472,932,190714,7,14
540,450,990,190714,7,15
481,534,1015,190714,7,16
395,522,917,190714,7,17
370,474,844,190714,7,18
293,384,677,190714,7,19
248,256,504,190714,7,20
173,176,349,190714,7,21
91,126,217,190714,7,22
56,101,157,190714,7,23
22,48,70,190714,7,24
16,22,38,190715,1,1
7,11,18,190715,1,2
11,11,22,190715,1,3
9,11,20,190715,1,4
38,38,76,190715,1,5
197,150,347,190715,1,6
448,345,793,190715,1,7
554,377,931,190715,1,8
444,387,831,190715,1,9
570,474,1044,190715,1,10
585,609,1194,190715,1,11
592,658,1250,190715,1,12
595,618,1213,190715,1,13
553,565,1118,190715,1,14
560,570,1130,190715,1,15
588,669,1257,190715,1,16
715,714,1429,190715,1,17
548,613,1161,190715,1,18
459,502,961,190715,1,19
323,314,637,190715,1,20
194,236,430,190715,1,21
122,132,254,190715,1,22
83,75,158,190715,1,23
30,34,64,190715,1,24
5,15,20,190716,2,1
11,12,23,190716,2,2
12,17,29,190716,2,3
4,17,21,190716,2,4
47,33,80,190716,2,5
163,139,302,190716,2,6
456,336,792,190716,2,7
581,367,948,190716,2,8
453,369,822,190716,2,9
539,510,1049,190716,2,10
583,627,1210,190716,2,11
622,575,1197,190716,2,12
541,563,1104,190716,2,13
560,572,1132,190716,2,14
597,544,1141,190716,2,15
617,617,1234,190716,2,16
759,687,1446,190716,2,17
569,623,1192,190716,2,18
423,582,1005,190716,2,19
309,316,625,190716,2,20
223,268,491,190716,2,21
141,211,352,190716,2,22
95,115,210,190716,2,23
37,65,102,190716,2,24
16,30,46,190717,3,1
9,7,16,190717,3,2
10,10,20,190717,3,3
7,12,19,190717,3,4
45,38,83,190717,3,5
185,130,315,190717,3,6
426,313,739,190717,3,7
561,387,948,190717,3,8
455,355,810,190717,3,9
554,462,1016,190717,3,10
616,601,1217,190717,3,11
592,610,1202,190717,3,12
579,572,1151,190717,3,13
545,559,1104,190717,3,14
577,631,1208,190717,3,15
603,670,1273,190717,3,16
742,727,1469,190717,3,17
561,616,1177,190717,3,18
409,479,888,190717,3,19
325,358,683,190717,3,20
230,267,497,190717,3,21
168,182,350,190717,3,22
85,131,216,190717,3,23
36,60,96,190717,3,24
17,32,49,190718,4,1
22,16,38,190718,4,2
14,17,31,190718,4,3
20,17,37,190718,4,4
44,36,80,190718,4,5
174,138,312,190718,4,6
433,314,747,190718,4,7
564,393,957,190718,4,8
460,379,839,190718,4,9
587,514,1101,190718,4,10
679,508,1187,190718,4,11
567,547,1114,190718,4,12
528,542,1070,190718,4,13
539,543,1082,190718,4,14
602,536,1138,190718,4,15
620,609,1229,190718,4,16
734,687,1421,190718,4,17
539,632,1171,190718,4,18
413,534,947,190718,4,19
288,321,609,190718,4,20
223,251,474,190718,4,21
126,185,311,190718,4,22
102,156,258,190718,4,23
50,61,111,190718,4,24
21,30,51,190719,5,1
4,17,21,190719,5,2
7,19,26,190719,5,3
8,18,26,190719,5,4
46,38,84,190719,5,5
177,143,320,190719,5,6
383,273,656,190719,5,7
512,353,865,190719,5,8
463,390,853,190719,5,9
514,517,1031,190719,5,10
591,567,1158,190719,5,11
619,650,1269,190719,5,12
667,767,1434,190719,5,13
655,599,1254,190719,5,14
676,643,1319,190719,5,15
629,645,1274,190719,5,16
610,662,1272,190719,5,17
550,603,1153,190719,5,18
472,569,1041,190719,5,19
330,407,737,190719,5,20
205,270,475,190719,5,21
144,207,351,190719,5,22
121,158,279,190719,5,23
78,78,156,190719,5,24
45,52,97,190720,6,1
31,34,65,190720,6,2
19,17,36,190720,6,3
17,19,36,190720,6,4
24,22,46,190720,6,5
74,56,130,190720,6,6
71,75,146,190720,6,7
171,131,302,190720,6,8
287,210,497,190720,6,9
430,389,819,190720,6,10
584,577,1161,190720,6,11
582,627,1209,190720,6,12
578,624,1202,190720,6,13
504,560,1064,190720,6,14
488,505,993,190720,6,15
434,483,917,190720,6,16
408,501,909,190720,6,17
380,529,909,190720,6,18
319,353,672,190720,6,19
231,294,525,190720,6,20
157,194,351,190720,6,21
115,169,284,190720,6,22
142,137,279,190720,6,23
83,85,168,190720,6,24
58,61,119,190721,7,1
42,34,76,190721,7,2
36,37,73,190721,7,3
30,20,50,190721,7,4
26,20,46,190721,7,5
54,48,102,190721,7,6
33,55,88,190721,7,7
64,56,120,190721,7,8
128,109,237,190721,7,9
259,211,470,190721,7,10
391,336,727,190721,7,11
465,422,887,190721,7,12
465,445,910,190721,7,13
493,486,979,190721,7,14
494,487,981,190721,7,15
433,534,967,190721,7,16
411,486,897,190721,7,17
412,461,873,190721,7,18
343,373,716,190721,7,19
237,261,498,190721,7,20
156,200,356,190721,7,21
106,128,234,190721,7,22
73,93,166,190721,7,23
18,35,53,190721,7,24
7,24,31,190722,1,1
9,12,21,190722,1,2
7,11,18,190722,1,3
13,13,26,190722,1,4
53,36,89,190722,1,5
186,150,336,190722,1,6
420,324,744,190722,1,7
532,387,919,190722,1,8
454,402,856,190722,1,9
561,485,1046,190722,1,10
605,571,1176,190722,1,11
576,622,1198,190722,1,12
567,591,1158,190722,1,13
598,560,1158,190722,1,14
552,573,1125,190722,1,15
577,616,1193,190722,1,16
709,723,1432,190722,1,17
540,584,1124,190722,1,18
392,481,873,190722,1,19
235,274,509,190722,1,20
171,197,368,190722,1,21
110,119,229,190722,1,22
69,84,153,190722,1,23
29,44,73,190722,1,24
18,22,40,190723,2,1
12,10,22,190723,2,2
10,8,18,190723,2,3
9,22,31,190723,2,4
52,32,84,190723,2,5
173,127,300,190723,2,6
433,294,727,190723,2,7
526,395,921,190723,2,8
469,401,870,190723,2,9
563,501,1064,190723,2,10
660,595,1255,190723,2,11
613,558,1171,190723,2,12
569,505,1074,190723,2,13
614,532,1146,190723,2,14
542,586,1128,190723,2,15
579,629,1208,190723,2,16
645,655,1300,190723,2,17
504,726,1230,190723,2,18
411,573,984,190723,2,19
327,355,682,190723,2,20
203,258,461,190723,2,21
117,214,331,190723,2,22
88,124,212,190723,2,23
39,48,87,190723,2,24
17,39,56,190724,3,1
11,10,21,190724,3,2
8,10,18,190724,3,3
13,26,39,190724,3,4
61,39,100,190724,3,5
179,124,303,190724,3,6
422,304,726,190724,3,7
537,376,913,190724,3,8
501,413,914,190724,3,9
601,479,1080,190724,3,10
713,566,1279,190724,3,11
612,543,1155,190724,3,12
640,563,1203,190724,3,13
576,594,1170,190724,3,14
552,574,1126,190724,3,15
602,676,1278,190724,3,16
634,719,1353,190724,3,17
544,654,1198,190724,3,18
431,592,1023,190724,3,19
335,360,695,190724,3,20
199,242,441,190724,3,21
152,160,312,190724,3,22
86,100,186,190724,3,23
42,61,103,190724,3,24
26,31,57,190725,4,1
14,15,29,190725,4,2
13,15,28,190725,4,3
14,22,36,190725,4,4
49,27,76,190725,4,5
174,142,316,190725,4,6
400,299,699,190725,4,7
532,361,893,190725,4,8
486,405,891,190725,4,9
558,487,1045,190725,4,10
645,515,1160,190725,4,11
604,538,1142,190725,4,12
590,544,1134,190725,4,13
597,556,1153,190725,4,14
576,574,1150,190725,4,15
668,650,1318,190725,4,16
620,725,1345,190725,4,17
591,721,1312,190725,4,18
464,606,1070,190725,4,19
343,487,830,190725,4,20
244,347,591,190725,4,21
176,287,463,190725,4,22
95,237,332,190725,4,23
51,119,170,190725,4,24
25,43,68,190726,5,1
7,13,20,190726,5,2
14,9,23,190726,5,3
6,22,28,190726,5,4
53,39,92,190726,5,5
180,149,329,190726,5,6
374,295,669,190726,5,7
490,340,830,190726,5,8
471,377,848,190726,5,9
556,510,1066,190726,5,10
657,650,1307,190726,5,11
668,676,1344,190726,5,12
682,651,1333,190726,5,13
614,764,1378,190726,5,14
598,643,1241,190726,5,15
567,607,1174,190726,5,16
565,605,1170,190726,5,17
510,582,1092,190726,5,18
423,551,974,190726,5,19
266,385,651,190726,5,20
224,267,491,190726,5,21
150,184,334,190726,5,22
102,127,229,190726,5,23
70,91,161,190726,5,24
44,61,105,190727,6,1
31,25,56,190727,6,2
18,24,42,190727,6,3
18,15,33,190727,6,4
20,21,41,190727,6,5
66,46,112,190727,6,6
65,86,151,190727,6,7
157,137,294,190727,6,8
294,260,554,190727,6,9
475,388,863,190727,6,10
607,506,1113,190727,6,11
620,597,1217,190727,6,12
653,529,1182,190727,6,13
583,578,1161,190727,6,14
578,516,1094,190727,6,15
461,468,929,190727,6,16
411,480,891,190727,6,17
433,512,945,190727,6,18
362,419,781,190727,6,19
280,316,596,190727,6,20
184,266,450,190727,6,21
127,161,288,190727,6,22
98,120,218,190727,6,23
72,104,176,190727,6,24
71,58,129,190728,7,1
39,50,89,190728,7,2
27,39,66,190728,7,3
23,31,54,190728,7,4
27,32,59,190728,7,5
56,49,105,190728,7,6
43,44,87,190728,7,7
67,64,131,190728,7,8
119,117,236,190728,7,9
235,235,470,190728,7,10
375,324,699,190728,7,11
430,414,844,190728,7,12
490,420,910,190728,7,13
444,470,914,190728,7,14
458,408,866,190728,7,15
441,428,869,190728,7,16
425,505,930,190728,7,17
386,540,926,190728,7,18
343,378,721,190728,7,19
285,305,590,190728,7,20
182,207,389,190728,7,21
129,186,315,190728,7,22
91,120,211,190728,7,23
35,53,88,190728,7,24
4,6,10,190729,1,1
7,16,23,190729,1,2
13,12,25,190729,1,3
11,17,28,190729,1,4
52,67,119,190729,1,5
197,145,342,190729,1,6
415,346,761,190729,1,7
540,388,928,190729,1,8
505,393,898,190729,1,9
540,547,1087,190729,1,10
601,580,1181,190729,1,11
561,530,1091,190729,1,12
589,532,1121,190729,1,13
543,509,1052,190729,1,14
565,530,1095,190729,1,15
602,655,1257,190729,1,16
666,740,1406,190729,1,17
522,599,1121,190729,1,18
370,548,918,190729,1,19
263,327,590,190729,1,20
177,242,419,190729,1,21
121,155,276,190729,1,22
88,83,171,190729,1,23
42,48,90,190729,1,24
18,19,37,190730,2,1
6,18,24,190730,2,2
11,12,23,190730,2,3
8,15,23,190730,2,4
48,32,80,190730,2,5
169,159,328,190730,2,6
443,325,768,190730,2,7
578,396,974,190730,2,8
520,371,891,190730,2,9
595,439,1034,190730,2,10
565,632,1197,190730,2,11
590,569,1159,190730,2,12
525,588,1113,190730,2,13
560,574,1134,190730,2,14
580,597,1177,190730,2,15
588,664,1252,190730,2,16
716,766,1482,190730,2,17
582,710,1292,190730,2,18
443,582,1025,190730,2,19
309,385,694,190730,2,20
196,228,424,190730,2,21
159,196,355,190730,2,22
86,130,216,190730,2,23
36,50,86,190730,2,24
25,27,52,190731,3,1
9,13,22,190731,3,2
12,10,22,190731,3,3
6,13,19,190731,3,4
47,36,83,190731,3,5
175,141,316,190731,3,6
425,307,732,190731,3,7
533,381,914,190731,3,8
490,381,871,190731,3,9
528,424,952,190731,3,10
573,567,1140,190731,3,11
572,628,1200,190731,3,12
557,652,1209,190731,3,13
546,599,1145,190731,3,14
559,633,1192,190731,3,15
531,698,1229,190731,3,16
694,705,1399,190731,3,17
570,600,1170,190731,3,18
515,484,999,190731,3,19
288,345,633,190731,3,20
190,243,433,190731,3,21
131,162,293,190731,3,22
81,141,222,190731,3,23
39,48,87,190731,3,24
17,26,43,190801,4,1
17,16,33,190801,4,2
12,10,22,190801,4,3
13,21,34,190801,4,4
47,34,81,190801,4,5
179,142,321,190801,4,6
417,325,742,190801,4,7
586,391,977,190801,4,8
461,414,875,190801,4,9
523,447,970,190801,4,10
617,537,1154,190801,4,11
570,586,1156,190801,4,12
544,569,1113,190801,4,13
484,527,1011,190801,4,14
584,607,1191,190801,4,15
620,644,1264,190801,4,16
747,778,1525,190801,4,17
544,628,1172,190801,4,18
419,484,903,190801,4,19
292,333,625,190801,4,20
201,246,447,190801,4,21
152,198,350,190801,4,22
100,121,221,190801,4,23
48,73,121,190801,4,24
23,42,65,190802,5,1
14,15,29,190802,5,2
12,14,26,190802,5,3
12,12,24,190802,5,4
51,36,87,190802,5,5
158,132,290,190802,5,6
390,307,697,190802,5,7
518,350,868,190802,5,8
449,368,817,190802,5,9
578,461,1039,190802,5,10
601,581,1182,190802,5,11
603,638,1241,190802,5,12
593,633,1226,190802,5,13
591,650,1241,190802,5,14
607,633,1240,190802,5,15
635,585,1220,190802,5,16
630,543,1173,190802,5,17
511,466,977,190802,5,18
374,471,845,190802,5,19
290,346,636,190802,5,20
200,264,464,190802,5,21
155,197,352,190802,5,22
101,195,296,190802,5,23
57,125,182,190802,5,24
48,63,111,190803,6,1
31,39,70,190803,6,2
23,20,43,190803,6,3
16,20,36,190803,6,4
27,22,49,190803,6,5
65,64,129,190803,6,6
87,61,148,190803,6,7
146,127,273,190803,6,8
262,237,499,190803,6,9
518,385,903,190803,6,10
646,537,1183,190803,6,11
618,503,1121,190803,6,12
624,499,1123,190803,6,13
608,465,1073,190803,6,14
618,445,1063,190803,6,15
516,559,1075,190803,6,16
500,566,1066,190803,6,17
461,521,982,190803,6,18
361,439,800,190803,6,19
273,278,551,190803,6,20
240,248,488,190803,6,21
148,278,426,190803,6,22
126,349,475,190803,6,23
81,186,267,190803,6,24
59,81,140,190804,7,1
47,52,99,190804,7,2
27,33,60,190804,7,3
26,29,55,190804,7,4
30,26,56,190804,7,5
50,52,102,190804,7,6
45,44,89,190804,7,7
68,70,138,190804,7,8
176,153,329,190804,7,9
289,303,592,190804,7,10
473,369,842,190804,7,11
571,384,955,190804,7,12
610,517,1127,190804,7,13
544,518,1062,190804,7,14
565,520,1085,190804,7,15
426,529,955,190804,7,16
436,581,1017,190804,7,17
376,619,995,190804,7,18
306,460,766,190804,7,19
292,302,594,190804,7,20
195,236,431,190804,7,21
152,190,342,190804,7,22
109,98,207,190804,7,23
29,200,229,190804,7,24
22,65,87,190805,1,1
12,20,32,190805,1,2
12,8,20,190805,1,3
16,13,29,190805,1,4
61,43,104,190805,1,5
166,138,304,190805,1,6
474,377,851,190805,1,7
611,410,1021,190805,1,8
534,392,926,190805,1,9
535,493,1028,190805,1,10
590,541,1131,190805,1,11
576,583,1159,190805,1,12
520,598,1118,190805,1,13
584,561,1145,190805,1,14
589,597,1186,190805,1,15
584,683,1267,190805,1,16
719,765,1484,190805,1,17
587,720,1307,190805,1,18
402,564,966,190805,1,19
284,310,594,190805,1,20
188,210,398,190805,1,21
171,170,341,190805,1,22
86,90,176,190805,1,23
32,41,73,190805,1,24
18,24,42,190806,2,1
10,20,30,190806,2,2
12,14,26,190806,2,3
16,22,38,190806,2,4
43,33,76,190806,2,5
181,142,323,190806,2,6
433,350,783,190806,2,7
596,442,1038,190806,2,8
518,456,974,190806,2,9
541,505,1046,190806,2,10
596,552,1148,190806,2,11
608,570,1178,190806,2,12
553,533,1086,190806,2,13
542,548,1090,190806,2,14
614,604,1218,190806,2,15
620,601,1221,190806,2,16
753,665,1418,190806,2,17
553,671,1224,190806,2,18
412,539,951,190806,2,19
286,354,640,190806,2,20
213,249,462,190806,2,21
164,187,351,190806,2,22
98,126,224,190806,2,23
44,41,85,190806,2,24
23,35,58,190807,3,1
27,21,48,190807,3,2
10,14,24,190807,3,3
9,18,27,190807,3,4
49,35,84,190807,3,5
175,149,324,190807,3,6
446,327,773,190807,3,7
618,443,1061,190807,3,8
571,412,983,190807,3,9
608,459,1067,190807,3,10
619,595,1214,190807,3,11
612,599,1211,190807,3,12
528,608,1136,190807,3,13
526,593,1119,190807,3,14
605,652,1257,190807,3,15
611,689,1300,190807,3,16
733,773,1506,190807,3,17
618,639,1257,190807,3,18
486,526,1012,190807,3,19
326,356,682,190807,3,20
218,241,459,190807,3,21
153,217,370,190807,3,22
89,166,255,190807,3,23
34,48,82,190807,3,24
30,25,55,190808,4,1
9,13,22,190808,4,2
10,11,21,190808,4,3
12,14,26,190808,4,4
39,31,70,190808,4,5
188,147,335,190808,4,6
452,361,813,190808,4,7
597,425,1022,190808,4,8
576,457,1033,190808,4,9
545,471,1016,190808,4,10
599,536,1135,190808,4,11
567,620,1187,190808,4,12
566,593,1159,190808,4,13
549,666,1215,190808,4,14
624,588,1212,190808,4,15
661,683,1344,190808,4,16
795,752,1547,190808,4,17
640,651,1291,190808,4,18
491,585,1076,190808,4,19
344,367,711,190808,4,20
236,237,473,190808,4,21
187,184,371,190808,4,22
106,128,234,190808,4,23
30,56,86,190808,4,24
22,29,51,190809,5,1
7,16,23,190809,5,2
17,10,27,190809,5,3
13,18,31,190809,5,4
41,30,71,190809,5,5
185,156,341,190809,5,6
393,302,695,190809,5,7
589,395,984,190809,5,8
559,405,964,190809,5,9
618,499,1117,190809,5,10
683,602,1285,190809,5,11
654,651,1305,190809,5,12
646,633,1279,190809,5,13
629,618,1247,190809,5,14
677,637,1314,190809,5,15
614,663,1277,190809,5,16
613,632,1245,190809,5,17
590,558,1148,190809,5,18
473,507,980,190809,5,19
348,328,676,190809,5,20
216,239,455,190809,5,21
145,164,309,190809,5,22
115,185,300,190809,5,23
56,141,197,190809,5,24
40,49,89,190810,6,1
30,32,62,190810,6,2
22,13,35,190810,6,3
13,19,32,190810,6,4
28,29,57,190810,6,5
51,53,104,190810,6,6
75,76,151,190810,6,7
162,146,308,190810,6,8
270,197,467,190810,6,9
441,392,833,190810,6,10
560,530,1090,190810,6,11
580,645,1225,190810,6,12
539,585,1124,190810,6,13
543,604,1147,190810,6,14
506,529,1035,190810,6,15
516,515,1031,190810,6,16
507,438,945,190810,6,17
436,411,847,190810,6,18
392,395,787,190810,6,19
281,321,602,190810,6,20
196,236,432,190810,6,21
151,158,309,190810,6,22
130,128,258,190810,6,23
89,92,181,190810,6,24
77,61,138,190811,7,1
46,38,84,190811,7,2
18,26,44,190811,7,3
15,19,34,190811,7,4
25,30,55,190811,7,5
63,43,106,190811,7,6
39,33,72,190811,7,7
79,79,158,190811,7,8
160,140,300,190811,7,9
321,287,608,190811,7,10
492,400,892,190811,7,11
552,478,1030,190811,7,12
685,508,1193,190811,7,13
604,508,1112,190811,7,14
600,512,1112,190811,7,15
520,562,1082,190811,7,16
491,536,1027,190811,7,17
420,553,973,190811,7,18
366,394,760,190811,7,19
245,343,588,190811,7,20
173,250,423,190811,7,21
120,265,385,190811,7,22
79,172,251,190811,7,23
23,52,75,190811,7,24
16,26,42,190812,1,1
6,26,32,190812,1,2
13,17,30,190812,1,3
16,12,28,190812,1,4
41,39,80,190812,1,5
233,181,414,190812,1,6
582,444,1026,190812,1,7
921,537,1458,190812,1,8
569,460,1029,190812,1,9
606,545,1151,190812,1,10
656,615,1271,190812,1,11
596,604,1200,190812,1,12
629,640,1269,190812,1,13
568,583,1151,190812,1,14
619,594,1213,190812,1,15
663,768,1431,190812,1,16
797,753,1550,190812,1,17
616,710,1326,190812,1,18
448,593,1041,190812,1,19
300,364,664,190812,1,20
211,252,463,190812,1,21
155,183,338,190812,1,22
71,84,155,190812,1,23
27,43,70,190812,1,24
27,27,54,190813,2,1
8,17,25,190813,2,2
11,16,27,190813,2,3
14,13,27,190813,2,4
46,47,93,190813,2,5
224,186,410,190813,2,6
599,399,998,190813,2,7
885,550,1435,190813,2,8
620,479,1099,190813,2,9
624,488,1112,190813,2,10
605,609,1214,190813,2,11
548,633,1181,190813,2,12
603,735,1338,190813,2,13
595,713,1308,190813,2,14
658,623,1281,190813,2,15
649,743,1392,190813,2,16
875,816,1691,190813,2,17
651,774,1425,190813,2,18
454,578,1032,190813,2,19
306,382,688,190813,2,20
214,272,486,190813,2,21
152,185,337,190813,2,22
66,113,179,190813,2,23
30,38,68,190813,2,24
24,16,40,190814,3,1
6,9,15,190814,3,2
10,10,20,190814,3,3
13,16,29,190814,3,4
42,35,77,190814,3,5
224,177,401,190814,3,6
606,360,966,190814,3,7
889,591,1480,190814,3,8
632,516,1148,190814,3,9
566,548,1114,190814,3,10
594,611,1205,190814,3,11
649,613,1262,190814,3,12
634,660,1294,190814,3,13
609,636,1245,190814,3,14
602,644,1246,190814,3,15
688,736,1424,190814,3,16
769,884,1653,190814,3,17
652,709,1361,190814,3,18
522,612,1134,190814,3,19
294,366,660,190814,3,20
223,265,488,190814,3,21
127,204,331,190814,3,22
91,99,190,190814,3,23
36,49,85,190814,3,24
25,28,53,190815,4,1
14,16,30,190815,4,2
7,8,15,190815,4,3
12,12,24,190815,4,4
51,32,83,190815,4,5
204,160,364,190815,4,6
582,411,993,190815,4,7
906,547,1453,190815,4,8
667,468,1135,190815,4,9
575,457,1032,190815,4,10
565,565,1130,190815,4,11
568,614,1182,190815,4,12
512,637,1149,190815,4,13
647,679,1326,190815,4,14
660,627,1287,190815,4,15
768,687,1455,190815,4,16
801,717,1518,190815,4,17
607,679,1286,190815,4,18
474,591,1065,190815,4,19
328,388,716,190815,4,20
209,262,471,190815,4,21
145,175,320,190815,4,22
110,123,233,190815,4,23
47,55,102,190815,4,24
18,28,46,190816,5,1
10,15,25,190816,5,2
10,10,20,190816,5,3
13,8,21,190816,5,4
46,36,82,190816,5,5
203,165,368,190816,5,6
544,355,899,190816,5,7
826,530,1356,190816,5,8
577,435,1012,190816,5,9
587,535,1122,190816,5,10
659,620,1279,190816,5,11
658,689,1347,190816,5,12
715,784,1499,190816,5,13
640,864,1504,190816,5,14
732,756,1488,190816,5,15
710,710,1420,190816,5,16
722,673,1395,190816,5,17
585,563,1148,190816,5,18
486,545,1031,190816,5,19
333,361,694,190816,5,20
255,279,534,190816,5,21
172,226,398,190816,5,22
126,158,284,190816,5,23
90,127,217,190816,5,24
52,53,105,190817,6,1
38,26,64,190817,6,2
19,30,49,190817,6,3
15,24,39,190817,6,4
20,23,43,190817,6,5
68,60,128,190817,6,6
98,67,165,190817,6,7
157,143,300,190817,6,8
303,221,524,190817,6,9
494,399,893,190817,6,10
597,539,1136,190817,6,11
627,626,1253,190817,6,12
575,614,1189,190817,6,13
476,541,1017,190817,6,14
481,568,1049,190817,6,15
482,535,1017,190817,6,16
439,443,882,190817,6,17
500,467,967,190817,6,18
359,419,778,190817,6,19
272,273,545,190817,6,20
192,235,427,190817,6,21
200,174,374,190817,6,22
102,141,243,190817,6,23
83,67,150,190817,6,24
63,64,127,190818,7,1
47,44,91,190818,7,2
34,32,66,190818,7,3
17,29,46,190818,7,4
22,24,46,190818,7,5
50,42,92,190818,7,6
60,56,116,190818,7,7
56,66,122,190818,7,8
109,115,224,190818,7,9
219,225,444,190818,7,10
350,334,684,190818,7,11
430,419,849,190818,7,12
487,464,951,190818,7,13
474,483,957,190818,7,14
510,514,1024,190818,7,15
450,449,899,190818,7,16
419,557,976,190818,7,17
485,491,976,190818,7,18
334,379,713,190818,7,19
234,281,515,190818,7,20
166,210,376,190818,7,21
125,151,276,190818,7,22
57,79,136,190818,7,23
25,33,58,190818,7,24
5,18,23,190819,1,1
14,16,30,190819,1,2
11,11,22,190819,1,3
12,18,30,190819,1,4
57,37,94,190819,1,5
219,180,399,190819,1,6
609,510,1119,190819,1,7
879,539,1418,190819,1,8
667,493,1160,190819,1,9
603,585,1188,190819,1,10
755,741,1496,190819,1,11
683,790,1473,190819,1,12
713,797,1510,190819,1,13
628,789,1417,190819,1,14
703,758,1461,190819,1,15
753,828,1581,190819,1,16
839,836,1675,190819,1,17
638,748,1386,190819,1,18
506,690,1196,190819,1,19
316,380,696,190819,1,20
198,240,438,190819,1,21
132,171,303,190819,1,22
67,89,156,190819,1,23
40,30,70,190819,1,24
15,18,33,190820,2,1
8,11,19,190820,2,2
11,10,21,190820,2,3
12,13,25,190820,2,4
47,35,82,190820,2,5
226,162,388,190820,2,6
598,423,1021,190820,2,7
892,587,1479,190820,2,8
633,492,1125,190820,2,9
562,488,1050,190820,2,10
576,569,1145,190820,2,11
573,577,1150,190820,2,12
564,601,1165,190820,2,13
564,685,1249,190820,2,14
658,619,1277,190820,2,15
635,782,1417,190820,2,16
781,844,1625,190820,2,17
545,725,1270,190820,2,18
445,543,988,190820,2,19
284,394,678,190820,2,20
207,247,454,190820,2,21
160,169,329,190820,2,22
71,113,184,190820,2,23
29,58,87,190820,2,24
24,13,37,190821,3,1
7,12,19,190821,3,2
11,10,21,190821,3,3
11,16,27,190821,3,4
44,41,85,190821,3,5
191,145,336,190821,3,6
553,390,943,190821,3,7
862,538,1400,190821,3,8
672,472,1144,190821,3,9
571,503,1074,190821,3,10
568,562,1130,190821,3,11
566,595,1161,190821,3,12
591,648,1239,190821,3,13
569,648,1217,190821,3,14
588,640,1228,190821,3,15
626,739,1365,190821,3,16
741,736,1477,190821,3,17
674,700,1374,190821,3,18
479,551,1030,190821,3,19
316,340,656,190821,3,20
230,271,501,190821,3,21
159,207,366,190821,3,22
82,110,192,190821,3,23
29,41,70,190821,3,24
22,24,46,190822,4,1
11,20,31,190822,4,2
10,10,20,190822,4,3
12,17,29,190822,4,4
47,30,77,190822,4,5
194,153,347,190822,4,6
563,420,983,190822,4,7
842,516,1358,190822,4,8
581,454,1035,190822,4,9
564,508,1072,190822,4,10
607,570,1177,190822,4,11
589,604,1193,190822,4,12
598,581,1179,190822,4,13
612,658,1270,190822,4,14
636,606,1242,190822,4,15
699,758,1457,190822,4,16
759,776,1535,190822,4,17
621,715,1336,190822,4,18
452,567,1019,190822,4,19
344,440,784,190822,4,20
224,281,505,190822,4,21
174,178,352,190822,4,22
94,131,225,190822,4,23
38,53,91,190822,4,24
12,23,35,190823,5,1
18,25,43,190823,5,2
8,10,18,190823,5,3
12,14,26,190823,5,4
55,35,90,190823,5,5
206,164,370,190823,5,6
498,352,850,190823,5,7
794,527,1321,190823,5,8
569,428,997,190823,5,9
546,524,1070,190823,5,10
650,528,1178,190823,5,11
707,646,1353,190823,5,12
762,723,1485,190823,5,13
645,772,1417,190823,5,14
669,670,1339,190823,5,15
700,628,1328,190823,5,16
716,638,1354,190823,5,17
571,614,1185,190823,5,18
462,566,1028,190823,5,19
327,361,688,190823,5,20
203,309,512,190823,5,21
150,258,408,190823,5,22
131,151,282,190823,5,23
66,103,169,190823,5,24
98,72,170,190824,6,1
45,37,82,190824,6,2
33,22,55,190824,6,3
18,15,33,190824,6,4
19,28,47,190824,6,5
76,57,133,190824,6,6
74,79,153,190824,6,7
163,127,290,190824,6,8
281,253,534,190824,6,9
522,437,959,190824,6,10
639,512,1151,190824,6,11
656,543,1199,190824,6,12
658,530,1188,190824,6,13
577,537,1114,190824,6,14
531,542,1073,190824,6,15
482,557,1039,190824,6,16
395,521,916,190824,6,17
414,548,962,190824,6,18
402,488,890,190824,6,19
245,353,598,190824,6,20
201,258,459,190824,6,21
153,207,360,190824,6,22
149,139,288,190824,6,23
101,112,213,190824,6,24
95,68,163,190825,7,1
71,41,112,190825,7,2
43,35,78,190825,7,3
23,23,46,190825,7,4
21,20,41,190825,7,5
52,45,97,190825,7,6
41,45,86,190825,7,7
81,70,151,190825,7,8
148,145,293,190825,7,9
338,273,611,190825,7,10
519,388,907,190825,7,11
669,390,1059,190825,7,12
705,431,1136,190825,7,13
579,471,1050,190825,7,14
528,498,1026,190825,7,15
389,609,998,190825,7,16
412,623,1035,190825,7,17
415,742,1157,190825,7,18
341,628,969,190825,7,19
286,378,664,190825,7,20
216,260,476,190825,7,21
123,162,285,190825,7,22
57,85,142,190825,7,23
24,44,68,190825,7,24
10,29,39,190826,1,1
4,12,16,190826,1,2
7,10,17,190826,1,3
6,13,19,190826,1,4
57,39,96,190826,1,5
216,166,382,190826,1,6
552,401,953,190826,1,7
841,537,1378,190826,1,8
593,437,1030,190826,1,9
547,526,1073,190826,1,10
575,554,1129,190826,1,11
578,565,1143,190826,1,12
534,594,1128,190826,1,13
591,639,1230,190826,1,14
626,575,1201,190826,1,15
638,672,1310,190826,1,16
782,762,1544,190826,1,17
580,686,1266,190826,1,18
402,581,983,190826,1,19
317,373,690,190826,1,20
224,258,482,190826,1,21
145,180,325,190826,1,22
77,90,167,190826,1,23
20,27,47,190826,1,24
7,26,33,190827,2,1
9,9,18,190827,2,2
14,13,27,190827,2,3
9,16,25,190827,2,4
49,28,77,190827,2,5
207,170,377,190827,2,6
595,402,997,190827,2,7
808,529,1337,190827,2,8
653,477,1130,190827,2,9
615,504,1119,190827,2,10
594,530,1124,190827,2,11
607,574,1181,190827,2,12
575,596,1171,190827,2,13
549,600,1149,190827,2,14
609,565,1174,190827,2,15
630,714,1344,190827,2,16
794,789,1583,190827,2,17
553,678,1231,190827,2,18
441,583,1024,190827,2,19
306,413,719,190827,2,20
205,282,487,190827,2,21
163,184,347,190827,2,22
58,99,157,190827,2,23
23,33,56,190827,2,24
18,15,33,190828,3,1
7,10,17,190828,3,2
11,10,21,190828,3,3
4,13,17,190828,3,4
56,38,94,190828,3,5
191,168,359,190828,3,6
531,399,930,190828,3,7
784,541,1325,190828,3,8
589,445,1034,190828,3,9
547,508,1055,190828,3,10
545,539,1084,190828,3,11
607,528,1135,190828,3,12
574,611,1185,190828,3,13
580,679,1259,190828,3,14
632,622,1254,190828,3,15
634,684,1318,190828,3,16
712,761,1473,190828,3,17
565,649,1214,190828,3,18
458,532,990,190828,3,19
318,401,719,190828,3,20
202,321,523,190828,3,21
157,221,378,190828,3,22
93,114,207,190828,3,23
48,46,94,190828,3,24
5,14,19,190829,4,1
8,9,17,190829,4,2
7,18,25,190829,4,3
9,12,21,190829,4,4
50,37,87,190829,4,5
187,165,352,190829,4,6
538,373,911,190829,4,7
794,483,1277,190829,4,8
534,454,988,190829,4,9
544,503,1047,190829,4,10
548,536,1084,190829,4,11
530,599,1129,190829,4,12
510,592,1102,190829,4,13
546,669,1215,190829,4,14
602,570,1172,190829,4,15
693,732,1425,190829,4,16
777,787,1564,190829,4,17
588,671,1259,190829,4,18
452,554,1006,190829,4,19
322,387,709,190829,4,20
222,242,464,190829,4,21
147,182,329,190829,4,22
92,133,225,190829,4,23
44,70,114,190829,4,24
18,21,39,190830,5,1
9,11,20,190830,5,2
15,9,24,190830,5,3
8,12,20,190830,5,4
49,39,88,190830,5,5
202,158,360,190830,5,6
490,354,844,190830,5,7
763,482,1245,190830,5,8
545,411,956,190830,5,9
550,505,1055,190830,5,10
608,578,1186,190830,5,11
651,609,1260,190830,5,12
627,663,1290,190830,5,13
602,725,1327,190830,5,14
626,656,1282,190830,5,15
679,593,1272,190830,5,16
652,635,1287,190830,5,17
524,536,1060,190830,5,18
453,553,1006,190830,5,19
333,413,746,190830,5,20
247,241,488,190830,5,21
230,197,427,190830,5,22
129,128,257,190830,5,23
83,121,204,190830,5,24
48,67,115,190831,6,1
35,49,84,190831,6,2
25,28,53,190831,6,3
10,15,25,190831,6,4
19,21,40,190831,6,5
66,46,112,190831,6,6
84,91,175,190831,6,7
182,157,339,190831,6,8
297,233,530,190831,6,9
508,413,921,190831,6,10
593,438,1031,190831,6,11
636,563,1199,190831,6,12
595,521,1116,190831,6,13
544,488,1032,190831,6,14
506,436,942,190831,6,15
376,444,820,190831,6,16
392,527,919,190831,6,17
416,533,949,190831,6,18
360,470,830,190831,6,19
264,394,658,190831,6,20
199,271,470,190831,6,21
164,203,367,190831,6,22
110,104,214,190831,6,23
84,93,177,190831,6,24
49,75,124,190901,7,1
39,45,84,190901,7,2
24,28,52,190901,7,3
22,27,49,190901,7,4
19,24,43,190901,7,5
49,47,96,190901,7,6
58,43,101,190901,7,7
89,63,152,190901,7,8
141,127,268,190901,7,9
258,266,524,190901,7,10
425,446,871,190901,7,11
523,515,1038,190901,7,12
527,517,1044,190901,7,13
595,503,1098,190901,7,14
519,467,986,190901,7,15
429,483,912,190901,7,16
403,601,1004,190901,7,17
401,609,1010,190901,7,18
303,342,645,190901,7,19
232,243,475,190901,7,20
172,208,380,190901,7,21
109,110,219,190901,7,22
75,75,150,190901,7,23
59,47,106,190901,7,24
14,26,40,190902,1,1
4,9,13,190902,1,2
9,7,16,190902,1,3
11,17,28,190902,1,4
53,37,90,190902,1,5
196,171,367,190902,1,6
560,428,988,190902,1,7
843,578,1421,190902,1,8
642,463,1105,190902,1,9
536,494,1030,190902,1,10
512,560,1072,190902,1,11
534,596,1130,190902,1,12
508,593,1101,190902,1,13
519,630,1149,190902,1,14
552,524,1076,190902,1,15
628,695,1323,190902,1,16
759,749,1508,190902,1,17
543,686,1229,190902,1,18
389,532,921,190902,1,19
302,304,606,190902,1,20
211,191,402,190902,1,21
130,164,294,190902,1,22
64,77,141,190902,1,23
15,36,51,190902,1,24
12,14,26,190903,2,1
7,10,17,190903,2,2
13,11,24,190903,2,3
12,20,32,190903,2,4
53,33,86,190903,2,5
209,163,372,190903,2,6
543,407,950,190903,2,7
790,514,1304,190903,2,8
566,405,971,190903,2,9
511,435,946,190903,2,10
478,507,985,190903,2,11
468,528,996,190903,2,12
497,558,1055,190903,2,13
516,612,1128,190903,2,14
611,605,1216,190903,2,15
590,685,1275,190903,2,16
740,753,1493,190903,2,17
584,662,1246,190903,2,18
443,496,939,190903,2,19
281,308,589,190903,2,20
182,243,425,190903,2,21
147,200,347,190903,2,22
65,94,159,190903,2,23
23,35,58,190903,2,24
12,15,27,190904,3,1
10,8,18,190904,3,2
5,9,14,190904,3,3
11,13,24,190904,3,4
51,33,84,190904,3,5
198,157,355,190904,3,6
534,408,942,190904,3,7
813,508,1321,190904,3,8
603,475,1078,190904,3,9
528,462,990,190904,3,10
484,530,1014,190904,3,11
498,532,1030,190904,3,12
479,558,1037,190904,3,13
458,553,1011,190904,3,14
528,542,1070,190904,3,15
584,727,1311,190904,3,16
737,719,1456,190904,3,17
606,684,1290,190904,3,18
415,507,922,190904,3,19
266,307,573,190904,3,20
170,182,352,190904,3,21
114,159,273,190904,3,22
75,82,157,190904,3,23
41,26,67,190904,3,24
14,12,26,190905,4,1
5,7,12,190905,4,2
11,16,27,190905,4,3
10,13,23,190905,4,4
51,34,85,190905,4,5
181,144,325,190905,4,6
526,413,939,190905,4,7
783,516,1299,190905,4,8
546,483,1029,190905,4,9
552,500,1052,190905,4,10
510,543,1053,190905,4,11
553,528,1081,190905,4,12
510,580,1090,190905,4,13
515,608,1123,190905,4,14
582,549,1131,190905,4,15
680,646,1326,190905,4,16
757,674,1431,190905,4,17
667,652,1319,190905,4,18
485,562,1047,190905,4,19
280,336,616,190905,4,20
176,218,394,190905,4,21
131,164,295,190905,4,22
74,109,183,190905,4,23
41,46,87,190905,4,24
15,18,33,190906,5,1
7,11,18,190906,5,2
9,7,16,190906,5,3
11,12,23,190906,5,4
43,26,69,190906,5,5
190,151,341,190906,5,6
497,374,871,190906,5,7
762,506,1268,190906,5,8
560,385,945,190906,5,9
476,471,947,190906,5,10
543,521,1064,190906,5,11
618,635,1253,190906,5,12
683,713,1396,190906,5,13
592,707,1299,190906,5,14
655,651,1306,190906,5,15
592,609,1201,190906,5,16
617,598,1215,190906,5,17
482,535,1017,190906,5,18
335,458,793,190906,5,19
298,291,589,190906,5,20
184,204,388,190906,5,21
124,143,267,190906,5,22
95,104,199,190906,5,23
66,72,138,190906,5,24
31,51,82,190907,6,1
37,28,65,190907,6,2
12,12,24,190907,6,3
9,17,26,190907,6,4
17,15,32,190907,6,5
74,50,124,190907,6,6
83,71,154,190907,6,7
139,137,276,190907,6,8
292,202,494,190907,6,9
478,370,848,190907,6,10
544,483,1027,190907,6,11
529,493,1022,190907,6,12
583,506,1089,190907,6,13
543,514,1057,190907,6,14
499,480,979,190907,6,15
357,455,812,190907,6,16
381,424,805,190907,6,17
374,413,787,190907,6,18
369,366,735,190907,6,19
218,284,502,190907,6,20
177,220,397,190907,6,21
132,131,263,190907,6,22
89,119,208,190907,6,23
59,61,120,190907,6,24
43,43,86,190908,7,1
29,35,64,190908,7,2
37,32,69,190908,7,3
21,27,48,190908,7,4
25,29,54,190908,7,5
44,44,88,190908,7,6
46,50,96,190908,7,7
71,55,126,190908,7,8
126,112,238,190908,7,9
282,254,536,190908,7,10
343,320,663,190908,7,11
402,372,774,190908,7,12
466,279,745,190908,7,13
441,440,881,190908,7,14
482,468,950,190908,7,15
394,443,837,190908,7,16
352,457,809,190908,7,17
354,526,880,190908,7,18
304,336,640,190908,7,19
193,254,447,190908,7,20
148,164,312,190908,7,21
99,94,193,190908,7,22
39,52,91,190908,7,23
21,25,46,190908,7,24
11,28,39,190909,1,1
8,9,17,190909,1,2
9,14,23,190909,1,3
8,18,26,190909,1,4
56,33,89,190909,1,5
190,157,347,190909,1,6
552,404,956,190909,1,7
825,510,1335,190909,1,8
568,432,1000,190909,1,9
558,489,1047,190909,1,10
514,583,1097,190909,1,11
524,564,1088,190909,1,12
553,589,1142,190909,1,13
507,617,1124,190909,1,14
595,572,1167,190909,1,15
603,660,1263,190909,1,16
810,737,1547,190909,1,17
577,650,1227,190909,1,18
431,537,968,190909,1,19
283,331,614,190909,1,20
156,235,391,190909,1,21
102,155,257,190909,1,22
55,77,132,190909,1,23
27,21,48,190909,1,24
13,15,28,190910,2,1
10,8,18,190910,2,2
8,13,21,190910,2,3
8,10,18,190910,2,4
51,30,81,190910,2,5
180,151,331,190910,2,6
568,402,970,190910,2,7
848,542,1390,190910,2,8
645,619,1264,190910,2,9
592,640,1232,190910,2,10
550,613,1163,190910,2,11
487,560,1047,190910,2,12
564,607,1171,190910,2,13
530,639,1169,190910,2,14
667,608,1275,190910,2,15
691,684,1375,190910,2,16
817,794,1611,190910,2,17
671,643,1314,190910,2,18
447,569,1016,190910,2,19
291,329,620,190910,2,20
174,223,397,190910,2,21
130,151,281,190910,2,22
56,81,137,190910,2,23
25,34,59,190910,2,24
12,19,31,190911,3,1
12,5,17,190911,3,2
12,18,30,190911,3,3
11,17,28,190911,3,4
60,35,95,190911,3,5
203,153,356,190911,3,6
567,398,965,190911,3,7
812,561,1373,190911,3,8
610,480,1090,190911,3,9
554,467,1021,190911,3,10
578,545,1123,190911,3,11
575,555,1130,190911,3,12
570,580,1150,190911,3,13
606,618,1224,190911,3,14
640,686,1326,190911,3,15
747,725,1472,190911,3,16
755,755,1510,190911,3,17
644,664,1308,190911,3,18
427,531,958,190911,3,19
309,378,687,190911,3,20
189,240,429,190911,3,21
124,140,264,190911,3,22
72,83,155,190911,3,23
23,39,62,190911,3,24
25,19,44,190912,4,1
5,12,17,190912,4,2
11,10,21,190912,4,3
15,17,32,190912,4,4
45,33,78,190912,4,5
194,154,348,190912,4,6
566,414,980,190912,4,7
849,569,1418,190912,4,8
668,512,1180,190912,4,9
582,558,1140,190912,4,10
578,595,1173,190912,4,11
558,561,1119,190912,4,12
612,671,1283,190912,4,13
681,694,1375,190912,4,14
665,641,1306,190912,4,15
781,726,1507,190912,4,16
842,777,1619,190912,4,17
690,717,1407,190912,4,18
483,520,1003,190912,4,19
303,348,651,190912,4,20
232,299,531,190912,4,21
169,224,393,190912,4,22
90,108,198,190912,4,23
26,41,67,190912,4,24
12,26,38,190913,5,1
9,16,25,190913,5,2
12,14,26,190913,5,3
13,15,28,190913,5,4
56,43,99,190913,5,5
165,143,308,190913,5,6
462,370,832,190913,5,7
758,526,1284,190913,5,8
571,422,993,190913,5,9
494,458,952,190913,5,10
559,535,1094,190913,5,11
640,606,1246,190913,5,12
679,671,1350,190913,5,13
647,745,1392,190913,5,14
676,619,1295,190913,5,15
571,635,1206,190913,5,16
578,660,1238,190913,5,17
510,570,1080,190913,5,18
378,479,857,190913,5,19
296,336,632,190913,5,20
201,212,413,190913,5,21
125,174,299,190913,5,22
89,141,230,190913,5,23
50,70,120,190913,5,24
30,27,57,190914,6,1
24,37,61,190914,6,2
18,17,35,190914,6,3
15,17,32,190914,6,4
18,32,50,190914,6,5
73,40,113,190914,6,6
74,79,153,190914,6,7
122,136,258,190914,6,8
305,222,527,190914,6,9
466,359,825,190914,6,10
514,495,1009,190914,6,11
538,543,1081,190914,6,12
531,473,1004,190914,6,13
450,469,919,190914,6,14
472,433,905,190914,6,15
384,444,828,190914,6,16
390,486,876,190914,6,17
410,441,851,190914,6,18
341,370,711,190914,6,19
276,261,537,190914,6,20
187,200,387,190914,6,21
123,153,276,190914,6,22
84,108,192,190914,6,23
47,59,106,190914,6,24
42,52,94,190915,7,1
36,32,68,190915,7,2
15,12,27,190915,7,3
15,20,35,190915,7,4
16,20,36,190915,7,5
54,38,92,190915,7,6
43,43,86,190915,7,7
54,67,121,190915,7,8
127,125,252,190915,7,9
303,208,511,190915,7,10
392,347,739,190915,7,11
475,395,870,190915,7,12
432,473,905,190915,7,13
456,434,890,190915,7,14
569,488,1057,190915,7,15
452,462,914,190915,7,16
421,490,911,190915,7,17
393,505,898,190915,7,18
270,355,625,190915,7,19
230,241,471,190915,7,20
145,176,321,190915,7,21
98,126,224,190915,7,22
68,64,132,190915,7,23
16,33,49,190915,7,24
9,31,40,190916,1,1
9,21,30,190916,1,2
11,15,26,190916,1,3
14,16,30,190916,1,4
51,39,90,190916,1,5
195,146,341,190916,1,6
548,383,931,190916,1,7
815,524,1339,190916,1,8
580,449,1029,190916,1,9
501,452,953,190916,1,10
520,549,1069,190916,1,11
519,532,1051,190916,1,12
567,527,1094,190916,1,13
478,605,1083,190916,1,14
535,577,1112,190916,1,15
613,663,1276,190916,1,16
706,747,1453,190916,1,17
534,674,1208,190916,1,18
374,441,815,190916,1,19
283,269,552,190916,1,20
164,200,364,190916,1,21
90,134,224,190916,1,22
41,76,117,190916,1,23
21,22,43,190916,1,24
4,14,18,190917,2,1
9,11,20,190917,2,2
6,11,17,190917,2,3
9,12,21,190917,2,4
47,35,82,190917,2,5
199,135,334,190917,2,6
528,404,932,190917,2,7
833,545,1378,190917,2,8
594,495,1089,190917,2,9
520,451,971,190917,2,10
492,522,1014,190917,2,11
542,545,1087,190917,2,12
492,591,1083,190917,2,13
475,600,1075,190917,2,14
583,562,1145,190917,2,15
593,683,1276,190917,2,16
661,739,1400,190917,2,17
546,656,1202,190917,2,18
382,500,882,190917,2,19
285,309,594,190917,2,20
142,194,336,190917,2,21
101,125,226,190917,2,22
55,74,129,190917,2,23
36,27,63,190917,2,24
16,17,33,190918,3,1
10,11,21,190918,3,2
5,16,21,190918,3,3
12,12,24,190918,3,4
46,35,81,190918,3,5
184,139,323,190918,3,6
516,397,913,190918,3,7
813,542,1355,190918,3,8
567,464,1031,190918,3,9
546,463,1009,190918,3,10
526,528,1054,190918,3,11
531,567,1098,190918,3,12
571,601,1172,190918,3,13
569,609,1178,190918,3,14
551,656,1207,190918,3,15
636,696,1332,190918,3,16
705,765,1470,190918,3,17
540,636,1176,190918,3,18
383,477,860,190918,3,19
260,280,540,190918,3,20
185,211,396,190918,3,21
125,166,291,190918,3,22
42,74,116,190918,3,23
29,27,56,190918,3,24
19,12,31,190919,4,1
5,9,14,190919,4,2
10,12,22,190919,4,3
13,12,25,190919,4,4
49,33,82,190919,4,5
189,133,322,190919,4,6
515,386,901,190919,4,7
806,528,1334,190919,4,8
591,442,1033,190919,4,9
522,445,967,190919,4,10
538,529,1067,190919,4,11
466,534,1000,190919,4,12
525,514,1039,190919,4,13
597,577,1174,190919,4,14
619,599,1218,190919,4,15
623,706,1329,190919,4,16
708,744,1452,190919,4,17
569,633,1202,190919,4,18
389,513,902,190919,4,19
286,320,606,190919,4,20
186,233,419,190919,4,21
113,168,281,190919,4,22
74,90,164,190919,4,23
23,42,65,190919,4,24
27,28,55,190920,5,1
14,11,25,190920,5,2
15,10,25,190920,5,3
11,11,22,190920,5,4
47,27,74,190920,5,5
195,146,341,190920,5,6
467,337,804,190920,5,7
750,496,1246,190920,5,8
593,422,1015,190920,5,9
503,469,972,190920,5,10
553,561,1114,190920,5,11
550,603,1153,190920,5,12
603,708,1311,190920,5,13
595,660,1255,190920,5,14
606,684,1290,190920,5,15
593,550,1143,190920,5,16
580,611,1191,190920,5,17
451,543,994,190920,5,18
372,440,812,190920,5,19
309,279,588,190920,5,20
172,218,390,190920,5,21
112,196,308,190920,5,22
48,20,68,190920,5,23
110,105,215,190920,5,24
46,37,83,190921,6,1
13,25,38,190921,6,2
15,12,27,190921,6,3
14,19,33,190921,6,4
28,25,53,190921,6,5
61,52,113,190921,6,6
69,58,127,190921,6,7
127,110,237,190921,6,8
258,223,481,190921,6,9
401,382,783,190921,6,10
526,486,1012,190921,6,11
544,480,1024,190921,6,12
531,464,995,190921,6,13
484,443,927,190921,6,14
418,453,871,190921,6,15
392,406,798,190921,6,16
374,411,785,190921,6,17
375,456,831,190921,6,18
371,358,729,190921,6,19
227,246,473,190921,6,20
171,204,375,190921,6,21
114,128,242,190921,6,22
84,102,186,190921,6,23
55,72,127,190921,6,24
43,43,86,190922,7,1
26,31,57,190922,7,2
15,21,36,190922,7,3
12,22,34,190922,7,4
25,27,52,190922,7,5
47,49,96,190922,7,6
43,48,91,190922,7,7
70,69,139,190922,7,8
164,114,278,190922,7,9
340,254,594,190922,7,10
495,403,898,190922,7,11
615,445,1060,190922,7,12
669,432,1101,190922,7,13
688,456,1144,190922,7,14
626,516,1142,190922,7,15
463,561,1024,190922,7,16
393,653,1046,190922,7,17
389,624,1013,190922,7,18
357,390,747,190922,7,19
252,312,564,190922,7,20
152,167,319,190922,7,21
94,126,220,190922,7,22
37,51,88,190922,7,23
16,33,49,190922,7,24
14,24,38,190923,1,1
8,7,15,190923,1,2
5,10,15,190923,1,3
14,17,31,190923,1,4
58,39,97,190923,1,5
194,157,351,190923,1,6
573,403,976,190923,1,7
848,536,1384,190923,1,8
569,438,1007,190923,1,9
556,483,1039,190923,1,10
537,508,1045,190923,1,11
519,540,1059,190923,1,12
494,549,1043,190923,1,13
531,586,1117,190923,1,14
531,515,1046,190923,1,15
612,671,1283,190923,1,16
720,792,1512,190923,1,17
542,693,1235,190923,1,18
357,459,816,190923,1,19
271,296,567,190923,1,20
140,198,338,190923,1,21
87,132,219,190923,1,22
48,60,108,190923,1,23
23,27,50,190923,1,24
11,17,28,190924,2,1
8,11,19,190924,2,2
7,9,16,190924,2,3
12,11,23,190924,2,4
43,34,77,190924,2,5
184,144,328,190924,2,6
560,398,958,190924,2,7
812,511,1323,190924,2,8
565,442,1007,190924,2,9
496,470,966,190924,2,10
483,485,968,190924,2,11
510,538,1048,190924,2,12
536,539,1075,190924,2,13
465,612,1077,190924,2,14
510,524,1034,190924,2,15
563,664,1227,190924,2,16
710,754,1464,190924,2,17
551,705,1256,190924,2,18
411,518,929,190924,2,19
283,331,614,190924,2,20
165,205,370,190924,2,21
107,112,219,190924,2,22
60,88,148,190924,2,23
16,32,48,190924,2,24
20,12,32,190925,3,1
9,16,25,190925,3,2
6,5,11,190925,3,3
11,11,22,190925,3,4
45,32,77,190925,3,5
193,137,330,190925,3,6
555,373,928,190925,3,7
770,537,1307,190925,3,8
596,420,1016,190925,3,9
549,435,984,190925,3,10
510,473,983,190925,3,11
458,505,963,190925,3,12
544,523,1067,190925,3,13
472,642,1114,190925,3,14
524,606,1130,190925,3,15
513,685,1198,190925,3,16
760,721,1481,190925,3,17
569,651,1220,190925,3,18
434,478,912,190925,3,19
240,313,553,190925,3,20
170,219,389,190925,3,21
88,179,267,190925,3,22
59,77,136,190925,3,23
34,27,61,190925,3,24
21,15,36,190926,4,1
6,17,23,190926,4,2
13,9,22,190926,4,3
12,13,25,190926,4,4
44,39,83,190926,4,5
190,140,330,190926,4,6
552,388,940,190926,4,7
807,541,1348,190926,4,8
567,463,1030,190926,4,9
492,468,960,190926,4,10
506,546,1052,190926,4,11
535,559,1094,190926,4,12
520,525,1045,190926,4,13
495,674,1169,190926,4,14
537,579,1116,190926,4,15
698,675,1373,190926,4,16
769,724,1493,190926,4,17
504,690,1194,190926,4,18
377,508,885,190926,4,19
261,305,566,190926,4,20
156,201,357,190926,4,21
152,140,292,190926,4,22
74,93,167,190926,4,23
26,45,71,190926,4,24
15,17,32,190927,5,1
9,13,22,190927,5,2
8,12,20,190927,5,3
16,12,28,190927,5,4
42,34,76,190927,5,5
197,126,323,190927,5,6
462,385,847,190927,5,7
738,556,1294,190927,5,8
531,441,972,190927,5,9
529,460,989,190927,5,10
491,481,972,190927,5,11
578,569,1147,190927,5,12
601,669,1270,190927,5,13
612,691,1303,190927,5,14
620,651,1271,190927,5,15
643,608,1251,190927,5,16
580,601,1181,190927,5,17
496,503,999,190927,5,18
369,432,801,190927,5,19
250,297,547,190927,5,20
147,232,379,190927,5,21
123,157,280,190927,5,22
89,102,191,190927,5,23
51,68,119,190927,5,24
30,44,74,190928,6,1
24,30,54,190928,6,2
11,18,29,190928,6,3
8,9,17,190928,6,4
23,22,45,190928,6,5
72,52,124,190928,6,6
72,66,138,190928,6,7
127,122,249,190928,6,8
257,237,494,190928,6,9
439,313,752,190928,6,10
535,428,963,190928,6,11
533,503,1036,190928,6,12
496,500,996,190928,6,13
428,470,898,190928,6,14
398,455,853,190928,6,15
381,434,815,190928,6,16
368,424,792,190928,6,17
401,424,825,190928,6,18
307,371,678,190928,6,19
193,287,480,190928,6,20
154,173,327,190928,6,21
97,139,236,190928,6,22
89,96,185,190928,6,23
75,71,146,190928,6,24
55,57,112,190929,7,1
33,38,71,190929,7,2
14,31,45,190929,7,3
22,22,44,190929,7,4
20,23,43,190929,7,5
45,39,84,190929,7,6
33,39,72,190929,7,7
43,49,92,190929,7,8
99,76,175,190929,7,9
198,189,387,190929,7,10
279,254,533,190929,7,11
360,405,765,190929,7,12
412,348,760,190929,7,13
330,404,734,190929,7,14
364,389,753,190929,7,15
313,344,657,190929,7,16
320,410,730,190929,7,17
349,370,719,190929,7,18
241,251,492,190929,7,19
146,195,341,190929,7,20
100,127,227,190929,7,21
76,94,170,190929,7,22
39,58,97,190929,7,23
8,28,36,190929,7,24
11,14,25,190930,1,1
3,15,18,190930,1,2
6,13,19,190930,1,3
10,11,21,190930,1,4
61,39,100,190930,1,5
206,171,377,190930,1,6
537,394,931,190930,1,7
808,549,1357,190930,1,8
548,456,1004,190930,1,9
482,486,968,190930,1,10
528,511,1039,190930,1,11
498,542,1040,190930,1,12
510,550,1060,190930,1,13
541,601,1142,190930,1,14
498,579,1077,190930,1,15
601,663,1264,190930,1,16
678,736,1414,190930,1,17
561,623,1184,190930,1,18
375,489,864,190930,1,19
284,308,592,190930,1,20
160,209,369,190930,1,21
97,139,236,190930,1,22
55,74,129,190930,1,23
25,27,52,190930,1,24
10,10,20,191001,2,1
10,10,20,191001,2,2
4,8,12,191001,2,3
8,13,21,191001,2,4
45,29,74,191001,2,5
187,139,326,191001,2,6
529,370,899,191001,2,7
768,541,1309,191001,2,8
594,397,991,191001,2,9
503,451,954,191001,2,10
504,535,1039,191001,2,11
523,533,1056,191001,2,12
489,539,1028,191001,2,13
499,611,1110,191001,2,14
532,580,1112,191001,2,15
567,674,1241,191001,2,16
678,658,1336,191001,2,17
517,655,1172,191001,2,18
404,501,905,191001,2,19
263,297,560,191001,2,20
167,205,372,191001,2,21
121,136,257,191001,2,22
55,89,144,191001,2,23
28,32,60,191001,2,24
16,16,32,191002,3,1
4,11,15,191002,3,2
8,9,17,191002,3,3
9,13,22,191002,3,4
47,39,86,191002,3,5
203,137,340,191002,3,6
521,374,895,191002,3,7
794,524,1318,191002,3,8
584,419,1003,191002,3,9
508,431,939,191002,3,10
501,523,1024,191002,3,11
534,555,1089,191002,3,12
575,626,1201,191002,3,13
599,675,1274,191002,3,14
544,650,1194,191002,3,15
635,683,1318,191002,3,16
710,765,1475,191002,3,17
580,631,1211,191002,3,18
441,463,904,191002,3,19
307,377,684,191002,3,20
200,219,419,191002,3,21
127,166,293,191002,3,22
84,106,190,191002,3,23
41,53,94,191002,3,24
37,50,87,191003,4,1
40,30,70,191003,4,2
20,24,44,191003,4,3
18,26,44,191003,4,4
25,18,43,191003,4,5
52,48,100,191003,4,6
44,51,95,191003,4,7
70,75,145,191003,4,8
119,142,261,191003,4,9
251,220,471,191003,4,10
363,301,664,191003,4,11
413,353,766,191003,4,12
440,375,815,191003,4,13
468,372,840,191003,4,14
418,422,840,191003,4,15
390,446,836,191003,4,16
344,477,821,191003,4,17
340,408,748,191003,4,18
295,313,608,191003,4,19
246,214,460,191003,4,20
122,167,289,191003,4,21
26,45,71,191003,4,22
49,64,113,191003,4,23
20,69,89,191003,4,24
10,22,32,191004,5,1
9,13,22,191004,5,2
14,8,22,191004,5,3
9,8,17,191004,5,4
36,37,73,191004,5,5
116,82,198,191004,5,6
223,145,368,191004,5,7
368,244,612,191004,5,8
377,314,691,191004,5,9
523,470,993,191004,5,10
582,547,1129,191004,5,11
553,552,1105,191004,5,12
561,593,1154,191004,5,13
527,555,1082,191004,5,14
495,567,1062,191004,5,15
531,548,1079,191004,5,16
498,484,982,191004,5,17
517,463,980,191004,5,18
437,368,805,191004,5,19
301,262,563,191004,5,20
153,197,350,191004,5,21
110,129,239,191004,5,22
66,87,153,191004,5,23
49,66,115,191004,5,24
29,31,60,191005,6,1
29,25,54,191005,6,2
18,13,31,191005,6,3
7,20,27,191005,6,4
22,20,42,191005,6,5
73,48,121,191005,6,6
61,71,132,191005,6,7
116,82,198,191005,6,8
250,215,465,191005,6,9
439,360,799,191005,6,10
502,506,1008,191005,6,11
519,543,1062,191005,6,12
491,588,1079,191005,6,13
413,636,1049,191005,6,14
394,592,986,191005,6,15
379,467,846,191005,6,16
340,472,812,191005,6,17
371,403,774,191005,6,18
296,323,619,191005,6,19
203,210,413,191005,6,20
122,133,255,191005,6,21
77,111,188,191005,6,22
73,80,153,191005,6,23
49,55,104,191005,6,24
38,45,83,191006,7,1
33,28,61,191006,7,2
21,26,47,191006,7,3
13,21,34,191006,7,4
19,15,34,191006,7,5
52,56,108,191006,7,6
43,51,94,191006,7,7
53,48,101,191006,7,8
108,97,205,191006,7,9
287,204,491,191006,7,10
435,357,792,191006,7,11
632,389,1021,191006,7,12
602,451,1053,191006,7,13
559,478,1037,191006,7,14
518,576,1094,191006,7,15
400,589,989,191006,7,16
350,621,971,191006,7,17
310,505,815,191006,7,18
248,246,494,191006,7,19
177,184,361,191006,7,20
133,146,279,191006,7,21
64,96,160,191006,7,22
38,58,96,191006,7,23
30,43,73,191006,7,24
12,17,29,191007,1,1
1,16,17,191007,1,2
9,14,23,191007,1,3
7,16,23,191007,1,4
43,36,79,191007,1,5
177,135,312,191007,1,6
494,395,889,191007,1,7
586,416,1002,191007,1,8
507,392,899,191007,1,9
509,487,996,191007,1,10
543,532,1075,191007,1,11
519,552,1071,191007,1,12
506,475,981,191007,1,13
488,537,1025,191007,1,14
496,535,1031,191007,1,15
535,632,1167,191007,1,16
719,749,1468,191007,1,17
510,557,1067,191007,1,18
400,443,843,191007,1,19
238,274,512,191007,1,20
134,158,292,191007,1,21
80,114,194,191007,1,22
46,75,121,191007,1,23
2,3,5,191007,1,24
12,9,21,191008,2,1
7,14,21,191008,2,2
8,8,16,191008,2,3
14,17,31,191008,2,4
30,39,69,191008,2,5
199,141,340,191008,2,6
463,382,845,191008,2,7
624,419,1043,191008,2,8
444,417,861,191008,2,9
441,395,836,191008,2,10
460,469,929,191008,2,11
530,500,1030,191008,2,12
475,479,954,191008,2,13
474,555,1029,191008,2,14
533,551,1084,191008,2,15
572,657,1229,191008,2,16
675,686,1361,191008,2,17
508,590,1098,191008,2,18
346,426,772,191008,2,19
235,267,502,191008,2,20
147,164,311,191008,2,21
73,111,184,191008,2,22
55,61,116,191008,2,23
19,27,46,191008,2,24
10,15,25,191009,3,1
8,15,23,191009,3,2
12,8,20,191009,3,3
9,10,19,191009,3,4
45,44,89,191009,3,5
195,143,338,191009,3,6
470,367,837,191009,3,7
578,432,1010,191009,3,8
493,385,878,191009,3,9
480,458,938,191009,3,10
523,544,1067,191009,3,11
559,500,1059,191009,3,12
520,508,1028,191009,3,13
485,546,1031,191009,3,14
488,564,1052,191009,3,15
530,666,1196,191009,3,16
666,676,1342,191009,3,17
501,558,1059,191009,3,18
382,456,838,191009,3,19
250,256,506,191009,3,20
134,147,281,191009,3,21
97,128,225,191009,3,22
62,63,125,191009,3,23
20,35,55,191009,3,24
16,24,40,191010,4,1
9,15,24,191010,4,2
12,7,19,191010,4,3
10,14,24,191010,4,4
44,37,81,191010,4,5
181,152,333,191010,4,6
472,349,821,191010,4,7
598,406,1004,191010,4,8
475,374,849,191010,4,9
466,418,884,191010,4,10
483,446,929,191010,4,11
495,513,1008,191010,4,12
541,525,1066,191010,4,13
511,549,1060,191010,4,14
546,594,1140,191010,4,15
602,637,1239,191010,4,16
657,678,1335,191010,4,17
537,615,1152,191010,4,18
359,443,802,191010,4,19
218,294,512,191010,4,20
128,185,313,191010,4,21
97,124,221,191010,4,22
64,73,137,191010,4,23
20,49,69,191010,4,24
11,13,24,191011,5,1
5,8,13,191011,5,2
7,5,12,191011,5,3
14,18,32,191011,5,4
46,33,79,191011,5,5
180,134,314,191011,5,6
443,325,768,191011,5,7
535,373,908,191011,5,8
436,344,780,191011,5,9
469,416,885,191011,5,10
560,521,1081,191011,5,11
585,547,1132,191011,5,12
596,621,1217,191011,5,13
578,644,1222,191011,5,14
617,647,1264,191011,5,15
574,548,1122,191011,5,16
549,591,1140,191011,5,17
448,424,872,191011,5,18
390,334,724,191011,5,19
226,247,473,191011,5,20
115,156,271,191011,5,21
89,117,206,191011,5,22
72,110,182,191011,5,23
51,61,112,191011,5,24
9,9,18,191012,6,1
14,22,36,191012,6,2
14,12,26,191012,6,3
12,9,21,191012,6,4
25,27,52,191012,6,5
60,50,110,191012,6,6
65,56,121,191012,6,7
113,91,204,191012,6,8
214,188,402,191012,6,9
339,279,618,191012,6,10
455,406,861,191012,6,11
545,480,1025,191012,6,12
623,501,1124,191012,6,13
619,511,1130,191012,6,14
637,450,1087,191012,6,15
552,427,979,191012,6,16
606,379,985,191012,6,17
492,351,843,191012,6,18
348,278,626,191012,6,19
200,211,411,191012,6,20
128,174,302,191012,6,21
100,123,223,191012,6,22
80,124,204,191012,6,23
52,58,110,191012,6,24
41,53,94,191013,7,1
28,36,64,191013,7,2
28,21,49,191013,7,3
19,24,43,191013,7,4
23,15,38,191013,7,5
44,34,78,191013,7,6
36,32,68,191013,7,7
45,41,86,191013,7,8
88,77,165,191013,7,9
184,145,329,191013,7,10
276,295,571,191013,7,11
344,335,679,191013,7,12
349,334,683,191013,7,13
367,399,766,191013,7,14
386,416,802,191013,7,15
331,336,667,191013,7,16
336,334,670,191013,7,17
336,343,679,191013,7,18
246,252,498,191013,7,19
165,186,351,191013,7,20
109,125,234,191013,7,21
61,110,171,191013,7,22
67,52,119,191013,7,23
18,42,60,191013,7,24
10,23,33,191014,1,1
7,14,21,191014,1,2
9,9,18,191014,1,3
10,9,19,191014,1,4
50,39,89,191014,1,5
200,172,372,191014,1,6
510,389,899,191014,1,7
619,400,1019,191014,1,8
498,391,889,191014,1,9
498,448,946,191014,1,10
576,520,1096,191014,1,11
540,575,1115,191014,1,12
513,503,1016,191014,1,13
473,498,971,191014,1,14
524,529,1053,191014,1,15
555,633,1188,191014,1,16
716,767,1483,191014,1,17
474,636,1110,191014,1,18
354,451,805,191014,1,19
256,273,529,191014,1,20
155,163,318,191014,1,21
121,119,240,191014,1,22
44,82,126,191014,1,23
26,26,52,191014,1,24
16,16,32,191015,2,1
4,2,6,191015,2,2
11,13,24,191015,2,3
8,26,34,191015,2,4
52,30,82,191015,2,5
207,136,343,191015,2,6
477,376,853,191015,2,7
653,426,1079,191015,2,8
514,434,948,191015,2,9
481,464,945,191015,2,10
560,560,1120,191015,2,11
583,537,1120,191015,2,12
633,621,1254,191015,2,13
611,584,1195,191015,2,14
631,592,1223,191015,2,15
731,731,1462,191015,2,16
790,798,1588,191015,2,17
540,670,1210,191015,2,18
413,478,891,191015,2,19
288,302,590,191015,2,20
164,203,367,191015,2,21
101,136,237,191015,2,22
51,72,123,191015,2,23
32,37,69,191015,2,24
24,20,44,191016,3,1
5,19,24,191016,3,2
9,15,24,191016,3,3
10,12,22,191016,3,4
49,30,79,191016,3,5
217,144,361,191016,3,6
471,364,835,191016,3,7
656,456,1112,191016,3,8
529,378,907,191016,3,9
482,448,930,191016,3,10
566,540,1106,191016,3,11
606,532,1138,191016,3,12
587,552,1139,191016,3,13
705,583,1288,191016,3,14
605,566,1171,191016,3,15
659,643,1302,191016,3,16
770,708,1478,191016,3,17
521,567,1088,191016,3,18
388,459,847,191016,3,19
238,252,490,191016,3,20
142,184,326,191016,3,21
99,133,232,191016,3,22
75,75,150,191016,3,23
29,44,73,191016,3,24
24,26,50,191017,4,1
9,13,22,191017,4,2
13,14,27,191017,4,3
13,11,24,191017,4,4
55,36,91,191017,4,5
185,149,334,191017,4,6
480,356,836,191017,4,7
629,412,1041,191017,4,8
496,401,897,191017,4,9
497,441,938,191017,4,10
505,529,1034,191017,4,11
540,570,1110,191017,4,12
551,589,1140,191017,4,13
486,564,1050,191017,4,14
568,609,1177,191017,4,15
618,651,1269,191017,4,16
728,747,1475,191017,4,17
508,602,1110,191017,4,18
377,512,889,191017,4,19
259,342,601,191017,4,20
146,159,305,191017,4,21
115,151,266,191017,4,22
118,84,202,191017,4,23
58,50,108,191017,4,24
22,16,38,191018,5,1
11,23,34,191018,5,2
12,14,26,191018,5,3
9,15,24,191018,5,4
48,32,80,191018,5,5
196,135,331,191018,5,6
452,344,796,191018,5,7
548,377,925,191018,5,8
507,395,902,191018,5,9
523,441,964,191018,5,10
566,536,1102,191018,5,11
620,611,1231,191018,5,12
589,714,1303,191018,5,13
623,608,1231,191018,5,14
618,655,1273,191018,5,15
573,585,1158,191018,5,16
570,580,1150,191018,5,17
468,483,951,191018,5,18
365,432,797,191018,5,19
225,314,539,191018,5,20
145,198,343,191018,5,21
123,154,277,191018,5,22
103,111,214,191018,5,23
48,58,106,191018,5,24
24,38,62,191019,6,1
27,31,58,191019,6,2
23,22,45,191019,6,3
18,25,43,191019,6,4
30,27,57,191019,6,5
73,58,131,191019,6,6
72,94,166,191019,6,7
136,96,232,191019,6,8
261,175,436,191019,6,9
414,351,765,191019,6,10
477,476,953,191019,6,11
541,531,1072,191019,6,12
561,567,1128,191019,6,13
488,524,1012,191019,6,14
524,497,1021,191019,6,15
415,437,852,191019,6,16
379,414,793,191019,6,17
356,396,752,191019,6,18
320,312,632,191019,6,19
218,244,462,191019,6,20
136,149,285,191019,6,21
102,121,223,191019,6,22
121,123,244,191019,6,23
71,104,175,191019,6,24
44,67,111,191020,7,1
49,36,85,191020,7,2
29,30,59,191020,7,3
15,23,38,191020,7,4
21,20,41,191020,7,5
52,49,101,191020,7,6
32,51,83,191020,7,7
53,63,116,191020,7,8
124,107,231,191020,7,9
190,193,383,191020,7,10
309,323,632,191020,7,11
378,346,724,191020,7,12
442,398,840,191020,7,13
439,412,851,191020,7,14
434,412,846,191020,7,15
373,462,835,191020,7,16
355,485,840,191020,7,17
368,427,795,191020,7,18
279,250,529,191020,7,19
175,179,354,191020,7,20
140,129,269,191020,7,21
68,90,158,191020,7,22
52,47,99,191020,7,23
20,24,44,191020,7,24
16,19,35,191021,1,1
6,16,22,191021,1,2
9,15,24,191021,1,3
10,16,26,191021,1,4
55,44,99,191021,1,5
213,162,375,191021,1,6
573,418,991,191021,1,7
812,507,1319,191021,1,8
558,441,999,191021,1,9
504,455,959,191021,1,10
514,519,1033,191021,1,11
499,550,1049,191021,1,12
516,545,1061,191021,1,13
509,582,1091,191021,1,14
523,561,1084,191021,1,15
630,717,1347,191021,1,16
686,722,1408,191021,1,17
487,595,1082,191021,1,18
332,495,827,191021,1,19
232,276,508,191021,1,20
137,147,284,191021,1,21
93,104,197,191021,1,22
44,65,109,191021,1,23
23,29,52,191021,1,24
9,15,24,191022,2,1
4,10,14,191022,2,2
6,9,15,191022,2,3
7,9,16,191022,2,4
51,39,90,191022,2,5
203,162,365,191022,2,6
561,418,979,191022,2,7
802,551,1353,191022,2,8
521,432,953,191022,2,9
504,454,958,191022,2,10
478,461,939,191022,2,11
448,532,980,191022,2,12
500,579,1079,191022,2,13
461,604,1065,191022,2,14
493,569,1062,191022,2,15
606,705,1311,191022,2,16
741,808,1549,191022,2,17
474,654,1128,191022,2,18
396,528,924,191022,2,19
247,341,588,191022,2,20
136,211,347,191022,2,21
107,145,252,191022,2,22
52,86,138,191022,2,23
33,36,69,191022,2,24
10,16,26,191023,3,1
7,8,15,191023,3,2
9,9,18,191023,3,3
8,13,21,191023,3,4
48,34,82,191023,3,5
199,158,357,191023,3,6
519,391,910,191023,3,7
836,527,1363,191023,3,8
568,386,954,191023,3,9
497,439,936,191023,3,10
483,496,979,191023,3,11
484,493,977,191023,3,12
540,566,1106,191023,3,13
512,601,1113,191023,3,14
497,600,1097,191023,3,15
578,748,1326,191023,3,16
715,738,1453,191023,3,17
488,594,1082,191023,3,18
414,515,929,191023,3,19
235,263,498,191023,3,20
142,163,305,191023,3,21
96,140,236,191023,3,22
67,82,149,191023,3,23
39,29,68,191023,3,24
16,18,34,191024,4,1
5,8,13,191024,4,2
4,9,13,191024,4,3
9,10,19,191024,4,4
54,33,87,191024,4,5
193,139,332,191024,4,6
529,388,917,191024,4,7
856,538,1394,191024,4,8
559,434,993,191024,4,9
472,435,907,191024,4,10
476,484,960,191024,4,11
536,525,1061,191024,4,12
505,573,1078,191024,4,13
550,608,1158,191024,4,14
549,610,1159,191024,4,15
621,662,1283,191024,4,16
751,786,1537,191024,4,17
523,638,1161,191024,4,18
403,512,915,191024,4,19
237,298,535,191024,4,20
164,210,374,191024,4,21
122,148,270,191024,4,22
71,93,164,191024,4,23
29,41,70,191024,4,24
15,15,30,191025,5,1
8,18,26,191025,5,2
4,3,7,191025,5,3
5,15,20,191025,5,4
44,30,74,191025,5,5
184,150,334,191025,5,6
514,384,898,191025,5,7
740,496,1236,191025,5,8
492,434,926,191025,5,9
488,458,946,191025,5,10
553,481,1034,191025,5,11
619,609,1228,191025,5,12
630,670,1300,191025,5,13
580,763,1343,191025,5,14
627,700,1327,191025,5,15
626,696,1322,191025,5,16
567,589,1156,191025,5,17
528,555,1083,191025,5,18
334,421,755,191025,5,19
236,291,527,191025,5,20
131,171,302,191025,5,21
138,208,346,191025,5,22
85,96,181,191025,5,23
65,75,140,191025,5,24
38,54,92,191026,6,1
28,35,63,191026,6,2
21,23,44,191026,6,3
9,14,23,191026,6,4
23,17,40,191026,6,5
61,51,112,191026,6,6
82,71,153,191026,6,7
138,115,253,191026,6,8
262,206,468,191026,6,9
360,329,689,191026,6,10
518,453,971,191026,6,11
530,492,1022,191026,6,12
480,443,923,191026,6,13
441,500,941,191026,6,14
463,429,892,191026,6,15
365,441,806,191026,6,16
327,385,712,191026,6,17
391,385,776,191026,6,18
308,326,634,191026,6,19
198,232,430,191026,6,20
128,180,308,191026,6,21
103,135,238,191026,6,22
76,89,165,191026,6,23
53,90,143,191026,6,24
38,63,101,191027,7,1
27,27,54,191027,7,2
18,20,38,191027,7,3
16,17,33,191027,7,4
13,7,20,191027,7,5
46,29,75,191027,7,6
30,37,67,191027,7,7
54,51,105,191027,7,8
117,91,208,191027,7,9
226,223,449,191027,7,10
355,319,674,191027,7,11
373,340,713,191027,7,12
459,384,843,191027,7,13
412,424,836,191027,7,14
370,446,816,191027,7,15
356,387,743,191027,7,16
349,405,754,191027,7,17
356,376,732,191027,7,18
220,219,439,191027,7,19
152,204,356,191027,7,20
114,120,234,191027,7,21
62,87,149,191027,7,22
38,61,99,191027,7,23
17,15,32,191027,7,24
11,12,23,191028,1,1
2,10,12,191028,1,2
9,12,21,191028,1,3
10,20,30,191028,1,4
55,35,90,191028,1,5
207,157,364,191028,1,6
568,389,957,191028,1,7
848,582,1430,191028,1,8
535,449,984,191028,1,9
501,490,991,191028,1,10
512,514,1026,191028,1,11
476,545,1021,191028,1,12
511,549,1060,191028,1,13
499,581,1080,191028,1,14
528,573,1101,191028,1,15
581,694,1275,191028,1,16
697,802,1499,191028,1,17
529,627,1156,191028,1,18
330,451,781,191028,1,19
226,222,448,191028,1,20
129,157,286,191028,1,21
92,132,224,191028,1,22
42,53,95,191028,1,23
23,30,53,191028,1,24
13,15,28,191029,2,1
7,7,14,191029,2,2
7,11,18,191029,2,3
13,13,26,191029,2,4
39,35,74,191029,2,5
181,146,327,191029,2,6
548,398,946,191029,2,7
845,579,1424,191029,2,8
564,466,1030,191029,2,9
513,451,964,191029,2,10
516,526,1042,191029,2,11
527,559,1086,191029,2,12
493,609,1102,191029,2,13
543,673,1216,191029,2,14
566,592,1158,191029,2,15
561,718,1279,191029,2,16
735,797,1532,191029,2,17
552,636,1188,191029,2,18
404,452,856,191029,2,19
232,290,522,191029,2,20
139,185,324,191029,2,21
109,157,266,191029,2,22
59,80,139,191029,2,23
25,38,63,191029,2,24
17,23,40,191030,3,1
7,10,17,191030,3,2
4,9,13,191030,3,3
11,13,24,191030,3,4
45,41,86,191030,3,5
172,135,307,191030,3,6
536,368,904,191030,3,7
814,545,1359,191030,3,8
609,451,1060,191030,3,9
533,474,1007,191030,3,10
501,537,1038,191030,3,11
559,548,1107,191030,3,12
541,625,1166,191030,3,13
527,718,1245,191030,3,14
584,705,1289,191030,3,15
619,755,1374,191030,3,16
677,744,1421,191030,3,17
581,639,1220,191030,3,18
391,508,899,191030,3,19
255,298,553,191030,3,20
162,180,342,191030,3,21
112,143,255,191030,3,22
89,101,190,191030,3,23
58,72,130,191030,3,24
49,54,103,191031,4,1
35,44,79,191031,4,2
23,34,57,191031,4,3
20,26,46,191031,4,4
24,28,52,191031,4,5
50,42,92,191031,4,6
54,44,98,191031,4,7
61,52,113,191031,4,8
116,98,214,191031,4,9
214,206,420,191031,4,10
309,283,592,191031,4,11
379,355,734,191031,4,12
432,370,802,191031,4,13
437,404,841,191031,4,14
456,441,897,191031,4,15
392,439,831,191031,4,16
374,439,813,191031,4,17
367,434,801,191031,4,18
302,324,626,191031,4,19
209,227,436,191031,4,20
141,155,296,191031,4,21
82,99,181,191031,4,22
49,64,113,191031,4,23
26,38,64,191031,4,24
10,26,36,191101,5,1
10,8,18,191101,5,2
11,14,25,191101,5,3
16,25,41,191101,5,4
13,18,31,191101,5,5
116,85,201,191101,5,6
295,188,483,191101,5,7
475,369,844,191101,5,8
457,379,836,191101,5,9
534,493,1027,191101,5,10
578,527,1105,191101,5,11
555,603,1158,191101,5,12
539,594,1133,191101,5,13
548,661,1209,191101,5,14
594,595,1189,191101,5,15
517,585,1102,191101,5,16
474,543,1017,191101,5,17
423,406,829,191101,5,18
271,314,585,191101,5,19
229,211,440,191101,5,20
131,164,295,191101,5,21
88,111,199,191101,5,22
88,98,186,191101,5,23
42,62,104,191101,5,24
41,47,88,191102,6,1
24,32,56,191102,6,2
9,12,21,191102,6,3
6,15,21,191102,6,4
21,23,44,191102,6,5
67,52,119,191102,6,6
65,58,123,191102,6,7
112,85,197,191102,6,8
247,228,475,191102,6,9
435,320,755,191102,6,10
438,399,837,191102,6,11
487,455,942,191102,6,12
441,442,883,191102,6,13
467,484,951,191102,6,14
402,503,905,191102,6,15
336,364,700,191102,6,16
369,394,763,191102,6,17
335,362,697,191102,6,18
282,315,597,191102,6,19
154,166,320,191102,6,20
106,154,260,191102,6,21
84,120,204,191102,6,22
81,125,206,191102,6,23
44,82,126,191102,6,24
40,63,103,191103,7,1
36,15,51,191103,7,2
21,24,45,191103,7,3
15,27,42,191103,7,4
15,18,33,191103,7,5
41,34,75,191103,7,6
41,44,85,191103,7,7
46,60,106,191103,7,8
129,95,224,191103,7,9
257,223,480,191103,7,10
376,320,696,191103,7,11
455,331,786,191103,7,12
510,404,914,191103,7,13
570,481,1051,191103,7,14
483,472,955,191103,7,15
424,502,926,191103,7,16
378,499,877,191103,7,17
316,389,705,191103,7,18
168,197,365,191103,7,19
134,170,304,191103,7,20
117,145,262,191103,7,21
64,90,154,191103,7,22
48,57,105,191103,7,23
17,24,41,191103,7,24
11,22,33,191104,1,1
5,10,15,191104,1,2
6,11,17,191104,1,3
10,12,22,191104,1,4
43,40,83,191104,1,5
228,175,403,191104,1,6
544,447,991,191104,1,7
854,538,1392,191104,1,8
566,469,1035,191104,1,9
507,439,946,191104,1,10
501,468,969,191104,1,11
461,471,932,191104,1,12
469,516,985,191104,1,13
505,542,1047,191104,1,14
527,489,1016,191104,1,15
493,655,1148,191104,1,16
707,626,1333,191104,1,17
538,604,1142,191104,1,18
339,431,770,191104,1,19
220,284,504,191104,1,20
126,166,292,191104,1,21
106,123,229,191104,1,22
46,83,129,191104,1,23
23,18,41,191104,1,24
9,9,18,191105,2,1
4,6,10,191105,2,2
9,14,23,191105,2,3
12,16,28,191105,2,4
32,35,67,191105,2,5
194,146,340,191105,2,6
566,429,995,191105,2,7
754,432,1186,191105,2,8
598,435,1033,191105,2,9
483,414,897,191105,2,10
487,460,947,191105,2,11
487,488,975,191105,2,12
519,547,1066,191105,2,13
440,565,1005,191105,2,14
528,533,1061,191105,2,15
532,645,1177,191105,2,16
708,673,1381,191105,2,17
516,614,1130,191105,2,18
313,468,781,191105,2,19
238,243,481,191105,2,20
134,162,296,191105,2,21
94,130,224,191105,2,22
64,71,135,191105,2,23
40,36,76,191105,2,24
10,13,23,191106,3,1
7,6,13,191106,3,2
7,14,21,191106,3,3
8,11,19,191106,3,4
42,44,86,191106,3,5
200,156,356,191106,3,6
568,397,965,191106,3,7
866,516,1382,191106,3,8
543,426,969,191106,3,9
485,366,851,191106,3,10
486,434,920,191106,3,11
433,475,908,191106,3,12
523,591,1114,191106,3,13
503,553,1056,191106,3,14
498,547,1045,191106,3,15
613,637,1250,191106,3,16
619,755,1374,191106,3,17
556,608,1164,191106,3,18
344,432,776,191106,3,19
215,266,481,191106,3,20
130,157,287,191106,3,21
118,125,243,191106,3,22
63,74,137,191106,3,23
25,32,57,191106,3,24
19,13,32,191107,4,1
7,8,15,191107,4,2
7,12,19,191107,4,3
12,12,24,191107,4,4
36,38,74,191107,4,5
193,149,342,191107,4,6
555,374,929,191107,4,7
830,571,1401,191107,4,8
588,417,1005,191107,4,9
496,451,947,191107,4,10
486,444,930,191107,4,11
462,514,976,191107,4,12
464,481,945,191107,4,13
521,533,1054,191107,4,14
549,513,1062,191107,4,15
607,638,1245,191107,4,16
696,681,1377,191107,4,17
523,595,1118,191107,4,18
457,473,930,191107,4,19
244,279,523,191107,4,20
135,189,324,191107,4,21
112,254,366,191107,4,22
78,102,180,191107,4,23
33,52,85,191107,4,24
14,18,32,191108,5,1
6,8,14,191108,5,2
7,12,19,191108,5,3
7,18,25,191108,5,4
36,33,69,191108,5,5
197,147,344,191108,5,6
534,381,915,191108,5,7
824,537,1361,191108,5,8
537,423,960,191108,5,9
551,448,999,191108,5,10
518,526,1044,191108,5,11
601,561,1162,191108,5,12
648,616,1264,191108,5,13
617,730,1347,191108,5,14
660,720,1380,191108,5,15
584,589,1173,191108,5,16
568,666,1234,191108,5,17
411,499,910,191108,5,18
300,396,696,191108,5,19
232,258,490,191108,5,20
140,160,300,191108,5,21
101,139,240,191108,5,22
65,135,200,191108,5,23
63,64,127,191108,5,24
28,40,68,191109,6,1
24,24,48,191109,6,2
14,12,26,191109,6,3
21,20,41,191109,6,4
21,22,43,191109,6,5
75,61,136,191109,6,6
80,61,141,191109,6,7
141,121,262,191109,6,8
261,205,466,191109,6,9
455,334,789,191109,6,10
599,469,1068,191109,6,11
633,503,1136,191109,6,12
477,505,982,191109,6,13
463,468,931,191109,6,14
443,475,918,191109,6,15
393,492,885,191109,6,16
408,501,909,191109,6,17
392,460,852,191109,6,18
275,302,577,191109,6,19
179,194,373,191109,6,20
135,182,317,191109,6,21
129,131,260,191109,6,22
91,118,209,191109,6,23
60,104,164,191109,6,24
47,51,98,191110,7,1
33,32,65,191110,7,2
25,31,56,191110,7,3
20,27,47,191110,7,4
19,16,35,191110,7,5
53,37,90,191110,7,6
51,35,86,191110,7,7
35,48,83,191110,7,8
114,73,187,191110,7,9
227,186,413,191110,7,10
262,319,581,191110,7,11
381,360,741,191110,7,12
502,378,880,191110,7,13
473,452,925,191110,7,14
429,495,924,191110,7,15
368,477,845,191110,7,16
405,432,837,191110,7,17
320,355,675,191110,7,18
230,228,458,191110,7,19
156,178,334,191110,7,20
109,126,235,191110,7,21
72,84,156,191110,7,22
52,48,100,191110,7,23
25,27,52,191110,7,24
9,24,33,191111,1,1
11,22,33,191111,1,2
6,9,15,191111,1,3
11,14,25,191111,1,4
47,43,90,191111,1,5
222,162,384,191111,1,6
603,446,1049,191111,1,7
837,545,1382,191111,1,8
595,457,1052,191111,1,9
535,470,1005,191111,1,10
535,512,1047,191111,1,11
518,537,1055,191111,1,12
512,572,1084,191111,1,13
493,616,1109,191111,1,14
582,575,1157,191111,1,15
609,790,1399,191111,1,16
748,791,1539,191111,1,17
534,671,1205,191111,1,18
338,561,899,191111,1,19
278,283,561,191111,1,20
164,157,321,191111,1,21
123,139,262,191111,1,22
57,62,119,191111,1,23
20,22,42,191111,1,24
11,16,27,191112,2,1
6,8,14,191112,2,2
12,8,20,191112,2,3
7,12,19,191112,2,4
37,36,73,191112,2,5
221,150,371,191112,2,6
594,449,1043,191112,2,7
836,554,1390,191112,2,8
560,439,999,191112,2,9
482,447,929,191112,2,10
473,507,980,191112,2,11
492,480,972,191112,2,12
463,520,983,191112,2,13
517,585,1102,191112,2,14
568,582,1150,191112,2,15
599,724,1323,191112,2,16
707,753,1460,191112,2,17
511,633,1144,191112,2,18
357,456,813,191112,2,19
207,271,478,191112,2,20
136,186,322,191112,2,21
105,137,242,191112,2,22
45,83,128,191112,2,23
30,29,59,191112,2,24
11,15,26,191113,3,1
12,16,28,191113,3,2
6,6,12,191113,3,3
8,9,17,191113,3,4
34,31,65,191113,3,5
217,151,368,191113,3,6
533,386,919,191113,3,7
822,536,1358,191113,3,8
607,429,1036,191113,3,9
562,437,999,191113,3,10
438,510,948,191113,3,11
514,517,1031,191113,3,12
470,582,1052,191113,3,13
527,608,1135,191113,3,14
533,588,1121,191113,3,15
587,708,1295,191113,3,16
664,806,1470,191113,3,17
473,573,1046,191113,3,18
359,469,828,191113,3,19
235,253,488,191113,3,20
158,179,337,191113,3,21
116,128,244,191113,3,22
76,93,169,191113,3,23
27,57,84,191113,3,24
20,21,41,191114,4,1
2,11,13,191114,4,2
13,13,26,191114,4,3
10,11,21,191114,4,4
46,33,79,191114,4,5
217,147,364,191114,4,6
521,407,928,191114,4,7
860,552,1412,191114,4,8
576,439,1015,191114,4,9
536,473,1009,191114,4,10
533,503,1036,191114,4,11
478,529,1007,191114,4,12
529,569,1098,191114,4,13
530,590,1120,191114,4,14
533,543,1076,191114,4,15
630,664,1294,191114,4,16
705,716,1421,191114,4,17
518,585,1103,191114,4,18
347,489,836,191114,4,19
253,293,546,191114,4,20
142,207,349,191114,4,21
135,131,266,191114,4,22
82,92,174,191114,4,23
31,61,92,191114,4,24
11,24,35,191115,5,1
10,8,18,191115,5,2
12,8,20,191115,5,3
4,10,14,191115,5,4
39,29,68,191115,5,5
224,150,374,191115,5,6
504,398,902,191115,5,7
794,526,1320,191115,5,8
518,427,945,191115,5,9
483,456,939,191115,5,10
520,462,982,191115,5,11
647,591,1238,191115,5,12
631,717,1348,191115,5,13
566,700,1266,191115,5,14
600,713,1313,191115,5,15
553,654,1207,191115,5,16
562,570,1132,191115,5,17
406,467,873,191115,5,18
349,372,721,191115,5,19
272,269,541,191115,5,20
149,187,336,191115,5,21
101,134,235,191115,5,22
99,127,226,191115,5,23
56,90,146,191115,5,24
42,42,84,191116,6,1
23,28,51,191116,6,2
20,12,32,191116,6,3
8,14,22,191116,6,4
19,23,42,191116,6,5
70,55,125,191116,6,6
58,57,115,191116,6,7
120,102,222,191116,6,8
247,195,442,191116,6,9
351,296,647,191116,6,10
471,398,869,191116,6,11
474,471,945,191116,6,12
479,458,937,191116,6,13
405,483,888,191116,6,14
365,417,782,191116,6,15
345,377,722,191116,6,16
328,343,671,191116,6,17
312,329,641,191116,6,18
259,311,570,191116,6,19
192,180,372,191116,6,20
148,159,307,191116,6,21
125,94,219,191116,6,22
84,102,186,191116,6,23
58,95,153,191116,6,24
33,74,107,191117,7,1
31,37,68,191117,7,2
21,31,52,191117,7,3
16,20,36,191117,7,4
21,23,44,191117,7,5
44,44,88,191117,7,6
37,42,79,191117,7,7
34,47,81,191117,7,8
99,80,179,191117,7,9
171,191,362,191117,7,10
255,286,541,191117,7,11
328,347,675,191117,7,12
457,332,789,191117,7,13
421,366,787,191117,7,14
420,439,859,191117,7,15
377,448,825,191117,7,16
376,389,765,191117,7,17
296,318,614,191117,7,18
204,226,430,191117,7,19
194,166,360,191117,7,20
121,132,253,191117,7,21
80,97,177,191117,7,22
48,58,106,191117,7,23
26,25,51,191117,7,24
11,19,30,191118,1,1
6,11,17,191118,1,2
5,5,10,191118,1,3
11,15,26,191118,1,4
49,38,87,191118,1,5
190,151,341,191118,1,6
549,428,977,191118,1,7
865,575,1440,191118,1,8
508,445,953,191118,1,9
512,457,969,191118,1,10
494,467,961,191118,1,11
469,515,984,191118,1,12
481,520,1001,191118,1,13
459,594,1053,191118,1,14
501,569,1070,191118,1,15
587,648,1235,191118,1,16
698,749,1447,191118,1,17
579,619,1198,191118,1,18
333,442,775,191118,1,19
243,267,510,191118,1,20
149,152,301,191118,1,21
97,130,227,191118,1,22
53,92,145,191118,1,23
22,31,53,191118,1,24
11,9,20,191119,2,1
5,10,15,191119,2,2
11,9,20,191119,2,3
7,10,17,191119,2,4
34,33,67,191119,2,5
198,148,346,191119,2,6
319,268,587,191119,2,7
794,563,1357,191119,2,8
489,406,895,191119,2,9
467,406,873,191119,2,10
443,443,886,191119,2,11
441,460,901,191119,2,12
459,488,947,191119,2,13
467,525,992,191119,2,14
556,577,1133,191119,2,15
592,645,1237,191119,2,16
671,720,1391,191119,2,17
530,621,1151,191119,2,18
358,419,777,191119,2,19
220,268,488,191119,2,20
134,172,306,191119,2,21
101,123,224,191119,2,22
65,79,144,191119,2,23
24,42,66,191119,2,24
17,23,40,191120,3,1
4,14,18,191120,3,2
5,5,10,191120,3,3
7,8,15,191120,3,4
38,33,71,191120,3,5
202,137,339,191120,3,6
489,385,874,191120,3,7
788,572,1360,191120,3,8
597,454,1051,191120,3,9
509,437,946,191120,3,10
475,478,953,191120,3,11
480,479,959,191120,3,12
452,576,1028,191120,3,13
485,556,1041,191120,3,14
517,592,1109,191120,3,15
565,707,1272,191120,3,16
649,748,1397,191120,3,17
480,585,1065,191120,3,18
362,407,769,191120,3,19
214,217,431,191120,3,20
155,181,336,191120,3,21
105,138,243,191120,3,22
74,91,165,191120,3,23
30,30,60,191120,3,24
22,9,31,191121,4,1
10,19,29,191121,4,2
9,13,22,191121,4,3
10,7,17,191121,4,4
35,40,75,191121,4,5
193,139,332,191121,4,6
501,396,897,191121,4,7
832,599,1431,191121,4,8
571,427,998,191121,4,9
494,434,928,191121,4,10
493,486,979,191121,4,11
438,520,958,191121,4,12
493,528,1021,191121,4,13
499,555,1054,191121,4,14
536,531,1067,191121,4,15
580,646,1226,191121,4,16
721,723,1444,191121,4,17
506,597,1103,191121,4,18
330,470,800,191121,4,19
237,295,532,191121,4,20
144,156,300,191121,4,21
122,146,268,191121,4,22
76,76,152,191121,4,23
41,40,81,191121,4,24
15,15,30,191122,5,1
10,9,19,191122,5,2
7,8,15,191122,5,3
7,15,22,191122,5,4
35,33,68,191122,5,5
203,140,343,191122,5,6
512,390,902,191122,5,7
767,523,1290,191122,5,8
561,449,1010,191122,5,9
453,435,888,191122,5,10
551,484,1035,191122,5,11
577,546,1123,191122,5,12
614,699,1313,191122,5,13
595,707,1302,191122,5,14
597,671,1268,191122,5,15
552,612,1164,191122,5,16
548,570,1118,191122,5,17
424,480,904,191122,5,18
321,371,692,191122,5,19
254,281,535,191122,5,20
129,178,307,191122,5,21
114,158,272,191122,5,22
90,167,257,191122,5,23
50,72,122,191122,5,24
26,49,75,191123,6,1
20,26,46,191123,6,2
6,13,19,191123,6,3
11,16,27,191123,6,4
21,24,45,191123,6,5
65,48,113,191123,6,6
73,63,136,191123,6,7
126,101,227,191123,6,8
253,204,457,191123,6,9
400,295,695,191123,6,10
517,438,955,191123,6,11
478,478,956,191123,6,12
500,483,983,191123,6,13
412,492,904,191123,6,14
402,491,893,191123,6,15
394,409,803,191123,6,16
394,425,819,191123,6,17
378,382,760,191123,6,18
272,354,626,191123,6,19
193,207,400,191123,6,20
126,180,306,191123,6,21
123,145,268,191123,6,22
108,98,206,191123,6,23
83,88,171,191123,6,24
52,46,98,191124,7,1
47,48,95,191124,7,2
30,33,63,191124,7,3
24,16,40,191124,7,4
24,21,45,191124,7,5
44,30,74,191124,7,6
40,49,89,191124,7,7
30,38,68,191124,7,8
88,98,186,191124,7,9
184,166,350,191124,7,10
263,295,558,191124,7,11
305,335,640,191124,7,12
379,330,709,191124,7,13
336,348,684,191124,7,14
417,374,791,191124,7,15
334,386,720,191124,7,16
338,333,671,191124,7,17
304,274,578,191124,7,18
209,247,456,191124,7,19
184,168,352,191124,7,20
105,128,233,191124,7,21
48,83,131,191124,7,22
52,68,120,191124,7,23
23,30,53,191124,7,24
11,20,31,191125,1,1
5,5,10,191125,1,2
4,8,12,191125,1,3
7,19,26,191125,1,4
56,30,86,191125,1,5
215,168,383,191125,1,6
474,391,865,191125,1,7
830,560,1390,191125,1,8
601,464,1065,191125,1,9
528,457,985,191125,1,10
522,508,1030,191125,1,11
474,529,1003,191125,1,12
468,569,1037,191125,1,13
489,594,1083,191125,1,14
501,562,1063,191125,1,15
606,646,1252,191125,1,16
658,710,1368,191125,1,17
496,566,1062,191125,1,18
328,471,799,191125,1,19
231,268,499,191125,1,20
140,147,287,191125,1,21
98,121,219,191125,1,22
48,61,109,191125,1,23
28,26,54,191125,1,24
12,11,23,191126,2,1
2,9,11,191126,2,2
8,10,18,191126,2,3
10,11,21,191126,2,4
37,35,72,191126,2,5
210,122,332,191126,2,6
517,415,932,191126,2,7
813,570,1383,191126,2,8
577,391,968,191126,2,9
490,457,947,191126,2,10
459,471,930,191126,2,11
506,480,986,191126,2,12
491,529,1020,191126,2,13
452,569,1021,191126,2,14
554,538,1092,191126,2,15
543,684,1227,191126,2,16
712,722,1434,191126,2,17
464,608,1072,191126,2,18
324,444,768,191126,2,19
242,240,482,191126,2,20
160,163,323,191126,2,21
99,126,225,191126,2,22
56,88,144,191126,2,23
30,32,62,191126,2,24
7,18,25,191127,3,1
7,14,21,191127,3,2
6,13,19,191127,3,3
7,16,23,191127,3,4
37,31,68,191127,3,5
196,137,333,191127,3,6
496,372,868,191127,3,7
787,550,1337,191127,3,8
528,412,940,191127,3,9
515,428,943,191127,3,10
497,454,951,191127,3,11
463,455,918,191127,3,12
466,540,1006,191127,3,13
480,595,1075,191127,3,14
542,575,1117,191127,3,15
552,697,1249,191127,3,16
667,697,1364,191127,3,17
474,547,1021,191127,3,18
322,418,740,191127,3,19
253,263,516,191127,3,20
149,176,325,191127,3,21
104,142,246,191127,3,22
58,72,130,191127,3,23
24,41,65,191127,3,24
20,12,32,191128,4,1
9,12,21,191128,4,2
6,9,15,191128,4,3
12,11,23,191128,4,4
33,36,69,191128,4,5
192,131,323,191128,4,6
514,388,902,191128,4,7
813,563,1376,191128,4,8
575,431,1006,191128,4,9
520,458,978,191128,4,10
459,479,938,191128,4,11
484,521,1005,191128,4,12
502,552,1054,191128,4,13
456,550,1006,191128,4,14
561,522,1083,191128,4,15
567,647,1214,191128,4,16
644,748,1392,191128,4,17
522,632,1154,191128,4,18
319,427,746,191128,4,19
274,287,561,191128,4,20
165,184,349,191128,4,21
102,139,241,191128,4,22
81,112,193,191128,4,23
27,38,65,191128,4,24
12,14,26,191129,5,1
8,8,16,191129,5,2
4,11,15,191129,5,3
7,15,22,191129,5,4
43,31,74,191129,5,5
184,132,316,191129,5,6
493,350,843,191129,5,7
744,494,1238,191129,5,8
534,435,969,191129,5,9
468,418,886,191129,5,10
532,483,1015,191129,5,11
596,585,1181,191129,5,12
562,607,1169,191129,5,13
668,688,1356,191129,5,14
641,656,1297,191129,5,15
620,589,1209,191129,5,16
568,589,1157,191129,5,17
410,457,867,191129,5,18
328,456,784,191129,5,19
219,246,465,191129,5,20
141,178,319,191129,5,21
116,144,260,191129,5,22
102,138,240,191129,5,23
56,83,139,191129,5,24
30,58,88,191130,6,1
30,31,61,191130,6,2
23,22,45,191130,6,3
16,24,40,191130,6,4
24,28,52,191130,6,5
75,50,125,191130,6,6
77,70,147,191130,6,7
138,90,228,191130,6,8
217,210,427,191130,6,9
360,287,647,191130,6,10
477,427,904,191130,6,11
514,490,1004,191130,6,12
458,507,965,191130,6,13
402,482,884,191130,6,14
422,427,849,191130,6,15
401,407,808,191130,6,16
343,412,755,191130,6,17
337,355,692,191130,6,18
245,290,535,191130,6,19
167,207,374,191130,6,20
118,187,305,191130,6,21
99,123,222,191130,6,22
101,97,198,191130,6,23
66,63,129,191130,6,24
45,36,81,191201,7,1
26,39,65,191201,7,2
17,27,44,191201,7,3
21,17,38,191201,7,4
19,40,59,191201,7,5
45,42,87,191201,7,6
33,48,81,191201,7,7
41,44,85,191201,7,8
116,83,199,191201,7,9
202,190,392,191201,7,10
278,334,612,191201,7,11
358,351,709,191201,7,12
441,384,825,191201,7,13
464,397,861,191201,7,14
469,462,931,191201,7,15
388,444,832,191201,7,16
379,368,747,191201,7,17
344,364,708,191201,7,18
198,286,484,191201,7,19
163,193,356,191201,7,20
130,139,269,191201,7,21
83,117,200,191201,7,22
37,59,96,191201,7,23
17,34,51,191201,7,24
8,28,36,191202,1,1
4,6,10,191202,1,2
8,10,18,191202,1,3
9,15,24,191202,1,4
53,48,101,191202,1,5
186,141,327,191202,1,6
548,403,951,191202,1,7
835,560,1395,191202,1,8
558,460,1018,191202,1,9
503,433,936,191202,1,10
505,475,980,191202,1,11
471,508,979,191202,1,12
460,527,987,191202,1,13
496,571,1067,191202,1,14
542,558,1100,191202,1,15
628,687,1315,191202,1,16
670,785,1455,191202,1,17
534,614,1148,191202,1,18
343,432,775,191202,1,19
222,282,504,191202,1,20
144,159,303,191202,1,21
99,136,235,191202,1,22
51,69,120,191202,1,23
24,28,52,191202,1,24
12,18,30,191203,2,1
8,9,17,191203,2,2
9,13,22,191203,2,3
10,6,16,191203,2,4
34,37,71,191203,2,5
207,145,352,191203,2,6
545,409,954,191203,2,7
794,545,1339,191203,2,8
570,463,1033,191203,2,9
539,429,968,191203,2,10
470,429,899,191203,2,11
481,512,993,191203,2,12
467,549,1016,191203,2,13
501,615,1116,191203,2,14
576,596,1172,191203,2,15
553,674,1227,191203,2,16
672,718,1390,191203,2,17
507,626,1133,191203,2,18
351,444,795,191203,2,19
225,279,504,191203,2,20
128,158,286,191203,2,21
108,116,224,191203,2,22
49,64,113,191203,2,23
29,24,53,191203,2,24
14,15,29,191204,3,1
9,11,20,191204,3,2
6,7,13,191204,3,3
8,10,18,191204,3,4
36,35,71,191204,3,5
196,152,348,191204,3,6
519,372,891,191204,3,7
772,533,1305,191204,3,8
553,448,1001,191204,3,9
491,397,888,191204,3,10
464,430,894,191204,3,11
470,481,951,191204,3,12
474,527,1001,191204,3,13
522,574,1096,191204,3,14
499,592,1091,191204,3,15
553,662,1215,191204,3,16
637,721,1358,191204,3,17
509,556,1065,191204,3,18
351,458,809,191204,3,19
204,242,446,191204,3,20
151,162,313,191204,3,21
124,147,271,191204,3,22
68,100,168,191204,3,23
26,32,58,191204,3,24
20,20,40,191205,4,1
8,11,19,191205,4,2
7,12,19,191205,4,3
13,13,26,191205,4,4
40,32,72,191205,4,5
179,132,311,191205,4,6
486,396,882,191205,4,7
825,554,1379,191205,4,8
581,397,978,191205,4,9
529,445,974,191205,4,10
492,486,978,191205,4,11
479,523,1002,191205,4,12
506,570,1076,191205,4,13
525,609,1134,191205,4,14
580,597,1177,191205,4,15
596,647,1243,191205,4,16
645,687,1332,191205,4,17
566,629,1195,191205,4,18
319,463,782,191205,4,19
234,284,518,191205,4,20
172,224,396,191205,4,21
110,167,277,191205,4,22
71,84,155,191205,4,23
32,34,66,191205,4,24
23,31,54,191206,5,1
12,11,23,191206,5,2
8,6,14,191206,5,3
10,18,28,191206,5,4
39,35,74,191206,5,5
182,136,318,191206,5,6
451,354,805,191206,5,7
754,518,1272,191206,5,8
555,430,985,191206,5,9
470,485,955,191206,5,10
479,455,934,191206,5,11
560,565,1125,191206,5,12
577,611,1188,191206,5,13
553,647,1200,191206,5,14
574,652,1226,191206,5,15
520,614,1134,191206,5,16
557,512,1069,191206,5,17
423,425,848,191206,5,18
373,396,769,191206,5,19
274,251,525,191206,5,20
155,183,338,191206,5,21
115,148,263,191206,5,22
103,166,269,191206,5,23
67,103,170,191206,5,24
44,61,105,191207,6,1
20,20,40,191207,6,2
22,30,52,191207,6,3
15,18,33,191207,6,4
20,19,39,191207,6,5
64,47,111,191207,6,6
81,65,146,191207,6,7
127,95,222,191207,6,8
293,191,484,191207,6,9
349,281,630,191207,6,10
439,423,862,191207,6,11
532,452,984,191207,6,12
488,599,1087,191207,6,13
474,530,1004,191207,6,14
373,485,858,191207,6,15
408,446,854,191207,6,16
382,400,782,191207,6,17
382,351,733,191207,6,18
294,311,605,191207,6,19
185,209,394,191207,6,20
115,156,271,191207,6,21
104,127,231,191207,6,22
75,91,166,191207,6,23
73,71,144,191207,6,24
44,61,105,191208,7,1
42,55,97,191208,7,2
22,25,47,191208,7,3
14,23,37,191208,7,4
16,14,30,191208,7,5
45,48,93,191208,7,6
40,47,87,191208,7,7
45,37,82,191208,7,8
76,76,152,191208,7,9
178,178,356,191208,7,10
210,272,482,191208,7,11
269,324,593,191208,7,12
339,312,651,191208,7,13
349,366,715,191208,7,14
390,416,806,191208,7,15
353,370,723,191208,7,16
336,295,631,191208,7,17
290,287,577,191208,7,18
226,282,508,191208,7,19
173,202,375,191208,7,20
110,137,247,191208,7,21
81,101,182,191208,7,22
56,56,112,191208,7,23
19,30,49,191208,7,24
10,25,35,191209,1,1
7,4,11,191209,1,2
7,6,13,191209,1,3
5,17,22,191209,1,4
52,39,91,191209,1,5
192,148,340,191209,1,6
543,408,951,191209,1,7
809,544,1353,191209,1,8
577,442,1019,191209,1,9
504,394,898,191209,1,10
530,470,1000,191209,1,11
491,488,979,191209,1,12
462,561,1023,191209,1,13
484,557,1041,191209,1,14
585,587,1172,191209,1,15
551,603,1154,191209,1,16
703,759,1462,191209,1,17
496,594,1090,191209,1,18
339,465,804,191209,1,19
215,290,505,191209,1,20
139,159,298,191209,1,21
84,108,192,191209,1,22
49,62,111,191209,1,23
27,22,49,191209,1,24
11,14,25,191210,2,1
5,9,14,191210,2,2
8,8,16,191210,2,3
14,9,23,191210,2,4
36,33,69,191210,2,5
188,150,338,191210,2,6
502,365,867,191210,2,7
826,532,1358,191210,2,8
544,422,966,191210,2,9
474,437,911,191210,2,10
511,486,997,191210,2,11
476,460,936,191210,2,12
490,507,997,191210,2,13
499,596,1095,191210,2,14
587,623,1210,191210,2,15
596,650,1246,191210,2,16
666,644,1310,191210,2,17
489,627,1116,191210,2,18
354,441,795,191210,2,19
217,254,471,191210,2,20
139,196,335,191210,2,21
118,108,226,191210,2,22
90,92,182,191210,2,23
32,29,61,191210,2,24
14,21,35,191211,3,1
4,6,10,191211,3,2
9,6,15,191211,3,3
7,9,16,191211,3,4
30,39,69,191211,3,5
196,131,327,191211,3,6
506,339,845,191211,3,7
796,545,1341,191211,3,8
568,393,961,191211,3,9
498,409,907,191211,3,10
455,467,922,191211,3,11
507,477,984,191211,3,12
467,523,990,191211,3,13
471,569,1040,191211,3,14
447,567,1014,191211,3,15
543,626,1169,191211,3,16
609,692,1301,191211,3,17
483,588,1071,191211,3,18
355,471,826,191211,3,19
234,249,483,191211,3,20
146,194,340,191211,3,21
111,148,259,191211,3,22
61,91,152,191211,3,23
29,36,65,191211,3,24
25,30,55,191212,4,1
11,22,33,191212,4,2
11,12,23,191212,4,3
10,9,19,191212,4,4
38,42,80,191212,4,5
166,120,286,191212,4,6
505,374,879,191212,4,7
825,547,1372,191212,4,8
571,424,995,191212,4,9
547,421,968,191212,4,10
515,463,978,191212,4,11
502,521,1023,191212,4,12
475,554,1029,191212,4,13
466,625,1091,191212,4,14
497,552,1049,191212,4,15
631,643,1274,191212,4,16
716,727,1443,191212,4,17
525,632,1157,191212,4,18
329,495,824,191212,4,19
233,305,538,191212,4,20
129,228,357,191212,4,21
122,181,303,191212,4,22
109,113,222,191212,4,23
48,47,95,191212,4,24
28,19,47,191213,5,1
14,12,26,191213,5,2
7,11,18,191213,5,3
14,19,33,191213,5,4
40,35,75,191213,5,5
164,118,282,191213,5,6
472,275,747,191213,5,7
719,479,1198,191213,5,8
551,418,969,191213,5,9
463,423,886,191213,5,10
491,470,961,191213,5,11
475,543,1018,191213,5,12
567,667,1234,191213,5,13
628,706,1334,191213,5,14
593,701,1294,191213,5,15
507,645,1152,191213,5,16
547,574,1121,191213,5,17
459,495,954,191213,5,18
384,422,806,191213,5,19
250,233,483,191213,5,20
138,170,308,191213,5,21
96,165,261,191213,5,22
101,133,234,191213,5,23
77,115,192,191213,5,24
54,78,132,191214,6,1
39,33,72,191214,6,2
23,30,53,191214,6,3
25,24,49,191214,6,4
39,34,73,191214,6,5
64,48,112,191214,6,6
70,59,129,191214,6,7
115,93,208,191214,6,8
235,155,390,191214,6,9
311,265,576,191214,6,10
442,375,817,191214,6,11
455,461,916,191214,6,12
421,402,823,191214,6,13
385,421,806,191214,6,14
360,396,756,191214,6,15
321,398,719,191214,6,16
306,367,673,191214,6,17
345,312,657,191214,6,18
294,280,574,191214,6,19
175,218,393,191214,6,20
130,132,262,191214,6,21
68,105,173,191214,6,22
75,91,166,191214,6,23
68,71,139,191214,6,24
51,50,101,191215,7,1
39,41,80,191215,7,2
27,19,46,191215,7,3
14,18,32,191215,7,4
15,18,33,191215,7,5
48,35,83,191215,7,6
34,30,64,191215,7,7
32,43,75,191215,7,8
83,61,144,191215,7,9
160,162,322,191215,7,10
226,227,453,191215,7,11
283,316,599,191215,7,12
369,304,673,191215,7,13
337,306,643,191215,7,14
430,408,838,191215,7,15
433,374,807,191215,7,16
329,354,683,191215,7,17
320,285,605,191215,7,18
197,219,416,191215,7,19
148,190,338,191215,7,20
109,156,265,191215,7,21
65,83,148,191215,7,22
46,50,96,191215,7,23
16,26,42,191215,7,24
9,17,26,191216,1,1
6,8,14,191216,1,2
9,9,18,191216,1,3
7,11,18,191216,1,4
42,34,76,191216,1,5
177,137,314,191216,1,6
511,383,894,191216,1,7
787,530,1317,191216,1,8
566,420,986,191216,1,9
518,437,955,191216,1,10
522,494,1016,191216,1,11
501,548,1049,191216,1,12
466,536,1002,191216,1,13
507,567,1074,191216,1,14
504,500,1004,191216,1,15
603,658,1261,191216,1,16
675,713,1388,191216,1,17
472,611,1083,191216,1,18
334,465,799,191216,1,19
221,275,496,191216,1,20
150,153,303,191216,1,21
85,96,181,191216,1,22
44,87,131,191216,1,23
33,37,70,191216,1,24
6,22,28,191217,2,1
6,9,15,191217,2,2
12,10,22,191217,2,3
12,14,26,191217,2,4
29,31,60,191217,2,5
180,126,306,191217,2,6
493,365,858,191217,2,7
727,512,1239,191217,2,8
569,387,956,191217,2,9
491,438,929,191217,2,10
504,462,966,191217,2,11
497,488,985,191217,2,12
447,557,1004,191217,2,13
509,620,1129,191217,2,14
629,540,1169,191217,2,15
560,673,1233,191217,2,16
660,721,1381,191217,2,17
495,638,1133,191217,2,18
339,470,809,191217,2,19
214,270,484,191217,2,20
121,183,304,191217,2,21
101,132,233,191217,2,22
62,81,143,191217,2,23
34,58,92,191217,2,24
15,15,30,191218,3,1
9,10,19,191218,3,2
11,7,18,191218,3,3
10,13,23,191218,3,4
37,39,76,191218,3,5
185,123,308,191218,3,6
466,324,790,191218,3,7
768,530,1298,191218,3,8
568,402,970,191218,3,9
544,456,1000,191218,3,10
527,492,1019,191218,3,11
548,568,1116,191218,3,12
515,571,1086,191218,3,13
486,576,1062,191218,3,14
511,663,1174,191218,3,15
574,687,1261,191218,3,16
657,717,1374,191218,3,17
465,538,1003,191218,3,18
338,487,825,191218,3,19
233,240,473,191218,3,20
138,191,329,191218,3,21
107,151,258,191218,3,22
79,73,152,191218,3,23
38,47,85,191218,3,24
23,25,48,191219,4,1
8,10,18,191219,4,2
6,7,13,191219,4,3
11,11,22,191219,4,4
39,38,77,191219,4,5
166,112,278,191219,4,6
428,318,746,191219,4,7
740,490,1230,191219,4,8
529,409,938,191219,4,9
527,439,966,191219,4,10
515,495,1010,191219,4,11
493,522,1015,191219,4,12
502,549,1051,191219,4,13
522,596,1118,191219,4,14
546,570,1116,191219,4,15
624,623,1247,191219,4,16
603,684,1287,191219,4,17
490,576,1066,191219,4,18
334,461,795,191219,4,19
249,307,556,191219,4,20
156,210,366,191219,4,21
126,145,271,191219,4,22
86,119,205,191219,4,23
50,65,115,191219,4,24
13,23,36,191220,5,1
14,19,33,191220,5,2
24,19,43,191220,5,3
28,22,50,191220,5,4
42,43,85,191220,5,5
151,97,248,191220,5,6
361,274,635,191220,5,7
677,464,1141,191220,5,8
475,387,862,191220,5,9
538,421,959,191220,5,10
582,503,1085,191220,5,11
553,621,1174,191220,5,12
602,686,1288,191220,5,13
543,637,1180,191220,5,14
564,621,1185,191220,5,15
557,554,1111,191220,5,16
513,523,1036,191220,5,17
479,522,1001,191220,5,18
289,396,685,191220,5,19
217,247,464,191220,5,20
130,177,307,191220,5,21
92,135,227,191220,5,22
73,120,193,191220,5,23
87,73,160,191220,5,24
41,47,88,191221,6,1
23,26,49,191221,6,2
7,17,24,191221,6,3
15,14,29,191221,6,4
22,26,48,191221,6,5
69,53,122,191221,6,6
64,53,117,191221,6,7
121,81,202,191221,6,8
226,195,421,191221,6,9
333,269,602,191221,6,10
496,408,904,191221,6,11
469,459,928,191221,6,12
426,449,875,191221,6,13
378,483,861,191221,6,14
397,387,784,191221,6,15
354,411,765,191221,6,16
334,356,690,191221,6,17
318,295,613,191221,6,18
207,296,503,191221,6,19
158,196,354,191221,6,20
108,146,254,191221,6,21
79,115,194,191221,6,22
57,74,131,191221,6,23
50,60,110,191221,6,24
34,41,75,191222,7,1
38,31,69,191222,7,2
16,26,42,191222,7,3
21,19,40,191222,7,4
10,12,22,191222,7,5
43,29,72,191222,7,6
30,47,77,191222,7,7
34,42,76,191222,7,8
64,62,126,191222,7,9
165,153,318,191222,7,10
221,213,434,191222,7,11
354,236,590,191222,7,12
412,282,694,191222,7,13
390,381,771,191222,7,14
429,446,875,191222,7,15
343,372,715,191222,7,16
301,450,751,191222,7,17
303,371,674,191222,7,18
185,269,454,191222,7,19
154,192,346,191222,7,20
106,134,240,191222,7,21
64,107,171,191222,7,22
51,59,110,191222,7,23
31,42,73,191222,7,24
19,29,48,191223,1,1
11,10,21,191223,1,2
10,14,24,191223,1,3
13,12,25,191223,1,4
27,25,52,191223,1,5
82,64,146,191223,1,6
199,125,324,191223,1,7
309,214,523,191223,1,8
394,297,691,191223,1,9
477,402,879,191223,1,10
547,471,1018,191223,1,11
542,529,1071,191223,1,12
548,507,1055,191223,1,13
440,505,945,191223,1,14
497,517,1014,191223,1,15
462,524,986,191223,1,16
435,471,906,191223,1,17
313,394,707,191223,1,18
259,352,611,191223,1,19
174,216,390,191223,1,20
130,147,277,191223,1,21
92,114,206,191223,1,22
46,79,125,191223,1,23
47,52,99,191223,1,24
19,28,47,191224,2,1
11,19,30,191224,2,2
16,17,33,191224,2,3
17,14,31,191224,2,4
20,18,38,191224,2,5
69,40,109,191224,2,6
59,68,127,191224,2,7
135,82,217,191224,2,8
193,140,333,191224,2,9
280,239,519,191224,2,10
350,318,668,191224,2,11
301,345,646,191224,2,12
286,379,665,191224,2,13
277,359,636,191224,2,14
279,331,610,191224,2,15
275,305,580,191224,2,16
271,244,515,191224,2,17
185,187,372,191224,2,18
104,86,190,191224,2,19
67,93,160,191224,2,20
103,100,203,191224,2,21
126,126,252,191224,2,22
156,151,307,191224,2,23
118,109,227,191224,2,24
65,68,133,191225,3,1
24,36,60,191225,3,2
12,16,28,191225,3,3
8,9,17,191225,3,4
12,12,24,191225,3,5
39,34,73,191225,3,6
31,31,62,191225,3,7
22,26,48,191225,3,8
49,53,102,191225,3,9
117,107,224,191225,3,10
202,212,414,191225,3,11
274,305,579,191225,3,12
274,291,565,191225,3,13
297,295,592,191225,3,14
352,343,695,191225,3,15
288,301,589,191225,3,16
282,282,564,191225,3,17
257,270,527,191225,3,18
206,197,403,191225,3,19
170,166,336,191225,3,20
145,150,295,191225,3,21
114,129,243,191225,3,22
74,84,158,191225,3,23
47,57,104,191225,3,24
27,30,57,191226,4,1
15,26,41,191226,4,2
24,26,50,191226,4,3
20,27,47,191226,4,4
19,21,40,191226,4,5
41,41,82,191226,4,6
33,30,63,191226,4,7
31,33,64,191226,4,8
58,54,112,191226,4,9
137,130,267,191226,4,10
221,229,450,191226,4,11
325,348,673,191226,4,12
362,349,711,191226,4,13
385,369,754,191226,4,14
408,433,841,191226,4,15
316,349,665,191226,4,16
290,285,575,191226,4,17
296,249,545,191226,4,18
218,215,433,191226,4,19
177,177,354,191226,4,20
147,171,318,191226,4,21
118,116,234,191226,4,22
60,59,119,191226,4,23
32,47,79,191226,4,24
21,30,51,191227,5,1
15,17,32,191227,5,2
3,12,15,191227,5,3
13,25,38,191227,5,4
33,30,63,191227,5,5
86,71,157,191227,5,6
132,102,234,191227,5,7
220,167,387,191227,5,8
263,222,485,191227,5,9
374,306,680,191227,5,10
495,407,902,191227,5,11
494,429,923,191227,5,12
455,435,890,191227,5,13
481,493,974,191227,5,14
479,491,970,191227,5,15
431,422,853,191227,5,16
327,412,739,191227,5,17
291,334,625,191227,5,18
249,316,565,191227,5,19
173,201,374,191227,5,20
133,156,289,191227,5,21
70,94,164,191227,5,22
66,94,160,191227,5,23
54,58,112,191227,5,24
21,35,56,191228,6,1
23,23,46,191228,6,2
9,11,20,191228,6,3
11,17,28,191228,6,4
27,27,54,191228,6,5
58,46,104,191228,6,6
55,51,106,191228,6,7
80,67,147,191228,6,8
190,129,319,191228,6,9
261,228,489,191228,6,10
408,341,749,191228,6,11
490,438,928,191228,6,12
475,511,986,191228,6,13
432,558,990,191228,6,14
385,560,945,191228,6,15
321,467,788,191228,6,16
345,392,737,191228,6,17
258,313,571,191228,6,18
184,232,416,191228,6,19
178,165,343,191228,6,20
108,157,265,191228,6,21
78,99,177,191228,6,22
66,97,163,191228,6,23
40,78,118,191228,6,24
39,39,78,191229,7,1
32,35,67,191229,7,2
20,15,35,191229,7,3
14,22,36,191229,7,4
19,12,31,191229,7,5
41,36,77,191229,7,6
28,40,68,191229,7,7
33,44,77,191229,7,8
67,57,124,191229,7,9
155,152,307,191229,7,10
231,221,452,191229,7,11
390,306,696,191229,7,12
441,357,798,191229,7,13
455,387,842,191229,7,14
446,404,850,191229,7,15
374,467,841,191229,7,16
268,411,679,191229,7,17
229,328,557,191229,7,18
186,222,408,191229,7,19
137,141,278,191229,7,20
97,128,225,191229,7,21
59,87,146,191229,7,22
52,57,109,191229,7,23
31,41,72,191229,7,24
20,31,51,191230,1,1
18,15,33,191230,1,2
7,10,17,191230,1,3
12,15,27,191230,1,4
18,18,36,191230,1,5
88,67,155,191230,1,6
147,119,266,191230,1,7
249,171,420,191230,1,8
278,205,483,191230,1,9
404,330,734,191230,1,10
502,433,935,191230,1,11
514,463,977,191230,1,12
488,473,961,191230,1,13
514,507,1021,191230,1,14
550,486,1036,191230,1,15
424,507,931,191230,1,16
410,470,880,191230,1,17
311,409,720,191230,1,18
251,339,590,191230,1,19
194,226,420,191230,1,20
130,159,289,191230,1,21
96,98,194,191230,1,22
76,66,142,191230,1,23
52,34,86,191230,1,24
35,74,109,191231,2,1
13,26,39,191231,2,2
11,16,27,191231,2,3
14,21,35,191231,2,4
26,24,50,191231,2,5
52,51,103,191231,2,6
73,68,141,191231,2,7
132,100,232,191231,2,8
200,141,341,191231,2,9
249,211,460,191231,2,10
356,290,646,191231,2,11
416,347,763,191231,2,12
300,333,633,191231,2,13
287,431,718,191231,2,14
330,394,724,191231,2,15
266,314,580,191231,2,16
251,261,512,191231,2,17
223,237,460,191231,2,18
181,175,356,191231,2,19
133,136,269,191231,2,20
97,93,190,191231,2,21
69,73,142,191231,2,22
60,37,97,191231,2,23
64,38,102,191231,2,24
