Cars-Direction-1,Cars-Direction-2,Cars-Total,Date,Day-Of-Week,Hour
36,62,98,2019-01-01,2,1
109,112,221,2019-01-01,2,2
97,60,157,2019-01-01,2,3
60,44,104,2019-01-01,2,4
44,33,77,2019-01-01,2,5
46,43,89,2019-01-01,2,6
39,41,80,2019-01-01,2,7
26,35,61,2019-01-01,2,8
38,19,57,2019-01-01,2,9
47,53,100,2019-01-01,2,10
112,111,223,2019-01-01,2,11
194,180,374,2019-01-01,2,12
306,234,540,2019-01-01,2,13
274,272,546,2019-01-01,2,14
303,315,618,2019-01-01,2,15
249,285,534,2019-01-01,2,16
267,278,545,2019-01-01,2,17
204,236,440,2019-01-01,2,18
124,149,273,2019-01-01,2,19
101,103,204,2019-01-01,2,20
83,75,158,2019-01-01,2,21
31,44,75,2019-01-01,2,22
29,40,69,2019-01-01,2,23
14,16,30,2019-01-01,2,24
11,14,25,2019-01-02,3,1
4,5,9,2019-01-02,3,2
4,4,8,2019-01-02,3,3
11,8,19,2019-01-02,3,4
30,40,70,2019-01-02,3,5
137,76,213,2019-01-02,3,6
266,198,464,2019-01-02,3,7
394,252,646,2019-01-02,3,8
359,277,636,2019-01-02,3,9
454,340,794,2019-01-02,3,10
495,431,926,2019-01-02,3,11
540,492,1032,2019-01-02,3,12
514,493,1007,2019-01-02,3,13
464,485,949,2019-01-02,3,14
522,511,1033,2019-01-02,3,15
495,529,1024,2019-01-02,3,16
485,578,1063,2019-01-02,3,17
360,486,846,2019-01-02,3,18
275,323,598,2019-01-02,3,19
165,212,377,2019-01-02,3,20
128,151,279,2019-01-02,3,21
68,80,148,2019-01-02,3,22
57,73,130,2019-01-02,3,23
30,37,67,2019-01-02,3,24
19,16,35,2019-01-03,4,1
13,12,25,2019-01-03,4,2
7,15,22,2019-01-03,4,3
9,9,18,2019-01-03,4,4
36,31,67,2019-01-03,4,5
120,80,200,2019-01-03,4,6
255,174,429,2019-01-03,4,7
438,274,712,2019-01-03,4,8
359,253,612,2019-01-03,4,9
379,309,688,2019-01-03,4,10
442,378,820,2019-01-03,4,11
482,432,914,2019-01-03,4,12
453,517,970,2019-01-03,4,13
486,528,1014,2019-01-03,4,14
511,500,1011,2019-01-03,4,15
483,587,1070,2019-01-03,4,16
515,583,1098,2019-01-03,4,17
384,496,880,2019-01-03,4,18
280,394,674,2019-01-03,4,19
152,237,389,2019-01-03,4,20
130,132,262,2019-01-03,4,21
87,111,198,2019-01-03,4,22
49,65,114,2019-01-03,4,23
22,42,64,2019-01-03,4,24
18,24,42,2019-01-04,5,1
13,10,23,2019-01-04,5,2
4,10,14,2019-01-04,5,3
10,13,23,2019-01-04,5,4
42,33,75,2019-01-04,5,5
112,86,198,2019-01-04,5,6
273,177,450,2019-01-04,5,7
395,269,664,2019-01-04,5,8
336,271,607,2019-01-04,5,9
408,323,731,2019-01-04,5,10
420,401,821,2019-01-04,5,11
481,441,922,2019-01-04,5,12
494,475,969,2019-01-04,5,13
499,446,945,2019-01-04,5,14
466,511,977,2019-01-04,5,15
434,496,930,2019-01-04,5,16
422,467,889,2019-01-04,5,17
342,400,742,2019-01-04,5,18
299,333,632,2019-01-04,5,19
188,178,366,2019-01-04,5,20
133,151,284,2019-01-04,5,21
103,123,226,2019-01-04,5,22
59,100,159,2019-01-04,5,23
36,55,91,2019-01-04,5,24
23,39,62,2019-01-05,6,1
27,37,64,2019-01-05,6,2
19,23,42,2019-01-05,6,3
14,10,24,2019-01-05,6,4
17,15,32,2019-01-05,6,5
57,36,93,2019-01-05,6,6
63,42,105,2019-01-05,6,7
96,75,171,2019-01-05,6,8
178,126,304,2019-01-05,6,9
299,226,525,2019-01-05,6,10
429,367,796,2019-01-05,6,11
468,392,860,2019-01-05,6,12
428,400,828,2019-01-05,6,13
472,454,926,2019-01-05,6,14
395,435,830,2019-01-05,6,15
364,363,727,2019-01-05,6,16
345,379,724,2019-01-05,6,17
304,346,650,2019-01-05,6,18
240,271,511,2019-01-05,6,19
148,223,371,2019-01-05,6,20
128,150,278,2019-01-05,6,21
88,112,200,2019-01-05,6,22
65,79,144,2019-01-05,6,23
94,91,185,2019-01-05,6,24
33,34,67,2019-01-06,7,1
47,31,78,2019-01-06,7,2
20,25,45,2019-01-06,7,3
17,15,32,2019-01-06,7,4
17,14,31,2019-01-06,7,5
40,32,72,2019-01-06,7,6
33,31,64,2019-01-06,7,7
46,37,83,2019-01-06,7,8
96,52,148,2019-01-06,7,9
184,126,310,2019-01-06,7,10
265,219,484,2019-01-06,7,11
301,268,569,2019-01-06,7,12
376,307,683,2019-01-06,7,13
389,370,759,2019-01-06,7,14
383,403,786,2019-01-06,7,15
305,380,685,2019-01-06,7,16
282,379,661,2019-01-06,7,17
260,312,572,2019-01-06,7,18
165,203,368,2019-01-06,7,19
125,157,282,2019-01-06,7,20
86,98,184,2019-01-06,7,21
44,80,124,2019-01-06,7,22
51,51,102,2019-01-06,7,23
17,28,45,2019-01-06,7,24
9,18,27,2019-01-07,1,1
9,10,19,2019-01-07,1,2
3,7,10,2019-01-07,1,3
17,15,32,2019-01-07,1,4
37,28,65,2019-01-07,1,5
201,159,360,2019-01-07,1,6
489,408,897,2019-01-07,1,7
783,482,1265,2019-01-07,1,8
546,346,892,2019-01-07,1,9
478,380,858,2019-01-07,1,10
444,473,917,2019-01-07,1,11
483,505,988,2019-01-07,1,12
474,527,1001,2019-01-07,1,13
462,533,995,2019-01-07,1,14
507,488,995,2019-01-07,1,15
538,632,1170,2019-01-07,1,16
650,723,1373,2019-01-07,1,17
492,557,1049,2019-01-07,1,18
315,464,779,2019-01-07,1,19
221,262,483,2019-01-07,1,20
126,149,275,2019-01-07,1,21
133,125,258,2019-01-07,1,22
36,85,121,2019-01-07,1,23
22,29,51,2019-01-07,1,24
6,20,26,2019-01-08,2,1
8,7,15,2019-01-08,2,2
8,6,14,2019-01-08,2,3
11,10,21,2019-01-08,2,4
33,26,59,2019-01-08,2,5
199,126,325,2019-01-08,2,6
501,396,897,2019-01-08,2,7
816,517,1333,2019-01-08,2,8
539,397,936,2019-01-08,2,9
464,357,821,2019-01-08,2,10
454,444,898,2019-01-08,2,11
437,450,887,2019-01-08,2,12
450,497,947,2019-01-08,2,13
458,528,986,2019-01-08,2,14
479,548,1027,2019-01-08,2,15
482,627,1109,2019-01-08,2,16
694,731,1425,2019-01-08,2,17
461,606,1067,2019-01-08,2,18
314,417,731,2019-01-08,2,19
235,260,495,2019-01-08,2,20
122,171,293,2019-01-08,2,21
71,129,200,2019-01-08,2,22
59,67,126,2019-01-08,2,23
25,25,50,2019-01-08,2,24
9,22,31,2019-01-09,3,1
10,6,16,2019-01-09,3,2
3,2,5,2019-01-09,3,3
12,13,25,2019-01-09,3,4
43,32,75,2019-01-09,3,5
204,139,343,2019-01-09,3,6
516,381,897,2019-01-09,3,7
800,505,1305,2019-01-09,3,8
533,378,911,2019-01-09,3,9
493,385,878,2019-01-09,3,10
427,408,835,2019-01-09,3,11
429,465,894,2019-01-09,3,12
492,517,1009,2019-01-09,3,13
447,542,989,2019-01-09,3,14
502,551,1053,2019-01-09,3,15
520,643,1163,2019-01-09,3,16
646,700,1346,2019-01-09,3,17
459,571,1030,2019-01-09,3,18
314,382,696,2019-01-09,3,19
202,237,439,2019-01-09,3,20
138,176,314,2019-01-09,3,21
103,122,225,2019-01-09,3,22
78,86,164,2019-01-09,3,23
26,40,66,2019-01-09,3,24
13,17,30,2019-01-10,4,1
13,15,28,2019-01-10,4,2
6,4,10,2019-01-10,4,3
12,16,28,2019-01-10,4,4
36,28,64,2019-01-10,4,5
193,138,331,2019-01-10,4,6
492,392,884,2019-01-10,4,7
824,502,1326,2019-01-10,4,8
527,389,916,2019-01-10,4,9
484,393,877,2019-01-10,4,10
446,464,910,2019-01-10,4,11
463,464,927,2019-01-10,4,12
431,496,927,2019-01-10,4,13
501,539,1040,2019-01-10,4,14
508,522,1030,2019-01-10,4,15
549,648,1197,2019-01-10,4,16
645,741,1386,2019-01-10,4,17
514,583,1097,2019-01-10,4,18
293,477,770,2019-01-10,4,19
211,281,492,2019-01-10,4,20
149,163,312,2019-01-10,4,21
99,114,213,2019-01-10,4,22
62,78,140,2019-01-10,4,23
33,38,71,2019-01-10,4,24
7,19,26,2019-01-11,5,1
6,8,14,2019-01-11,5,2
9,9,18,2019-01-11,5,3
10,10,20,2019-01-11,5,4
34,31,65,2019-01-11,5,5
189,128,317,2019-01-11,5,6
473,372,845,2019-01-11,5,7
757,519,1276,2019-01-11,5,8
457,395,852,2019-01-11,5,9
480,363,843,2019-01-11,5,10
496,442,938,2019-01-11,5,11
559,563,1122,2019-01-11,5,12
631,638,1269,2019-01-11,5,13
591,667,1258,2019-01-11,5,14
544,670,1214,2019-01-11,5,15
507,597,1104,2019-01-11,5,16
528,590,1118,2019-01-11,5,17
443,474,917,2019-01-11,5,18
300,383,683,2019-01-11,5,19
214,230,444,2019-01-11,5,20
148,154,302,2019-01-11,5,21
121,127,248,2019-01-11,5,22
69,113,182,2019-01-11,5,23
55,74,129,2019-01-11,5,24
29,29,58,2019-01-12,6,1
16,29,45,2019-01-12,6,2
14,16,30,2019-01-12,6,3
10,15,25,2019-01-12,6,4
12,14,26,2019-01-12,6,5
62,48,110,2019-01-12,6,6
57,58,115,2019-01-12,6,7
122,90,212,2019-01-12,6,8
220,152,372,2019-01-12,6,9
319,250,569,2019-01-12,6,10
423,388,811,2019-01-12,6,11
418,500,918,2019-01-12,6,12
446,447,893,2019-01-12,6,13
389,400,789,2019-01-12,6,14
344,414,758,2019-01-12,6,15
341,408,749,2019-01-12,6,16
306,348,654,2019-01-12,6,17
331,348,679,2019-01-12,6,18
238,279,517,2019-01-12,6,19
179,171,350,2019-01-12,6,20
168,132,300,2019-01-12,6,21
88,108,196,2019-01-12,6,22
69,100,169,2019-01-12,6,23
40,78,118,2019-01-12,6,24
48,46,94,2019-01-13,7,1
25,43,68,2019-01-13,7,2
20,26,46,2019-01-13,7,3
15,21,36,2019-01-13,7,4
17,15,32,2019-01-13,7,5
37,40,77,2019-01-13,7,6
34,30,64,2019-01-13,7,7
39,43,82,2019-01-13,7,8
71,48,119,2019-01-13,7,9
176,170,346,2019-01-13,7,10
223,252,475,2019-01-13,7,11
256,268,524,2019-01-13,7,12
334,295,629,2019-01-13,7,13
342,330,672,2019-01-13,7,14
346,374,720,2019-01-13,7,15
313,364,677,2019-01-13,7,16
293,290,583,2019-01-13,7,17
306,305,611,2019-01-13,7,18
197,206,403,2019-01-13,7,19
145,194,339,2019-01-13,7,20
110,149,259,2019-01-13,7,21
55,74,129,2019-01-13,7,22
40,43,83,2019-01-13,7,23
15,27,42,2019-01-13,7,24
9,24,33,2019-01-14,1,1
5,9,14,2019-01-14,1,2
7,10,17,2019-01-14,1,3
7,12,19,2019-01-14,1,4
44,40,84,2019-01-14,1,5
211,176,387,2019-01-14,1,6
547,388,935,2019-01-14,1,7
822,570,1392,2019-01-14,1,8
564,380,944,2019-01-14,1,9
473,434,907,2019-01-14,1,10
472,446,918,2019-01-14,1,11
452,488,940,2019-01-14,1,12
511,526,1037,2019-01-14,1,13
485,538,1023,2019-01-14,1,14
554,515,1069,2019-01-14,1,15
538,625,1163,2019-01-14,1,16
620,790,1410,2019-01-14,1,17
466,610,1076,2019-01-14,1,18
327,470,797,2019-01-14,1,19
254,275,529,2019-01-14,1,20
136,142,278,2019-01-14,1,21
90,110,200,2019-01-14,1,22
49,99,148,2019-01-14,1,23
17,35,52,2019-01-14,1,24
9,12,21,2019-01-15,2,1
8,8,16,2019-01-15,2,2
6,8,14,2019-01-15,2,3
11,12,23,2019-01-15,2,4
37,41,78,2019-01-15,2,5
204,137,341,2019-01-15,2,6
539,380,919,2019-01-15,2,7
814,530,1344,2019-01-15,2,8
551,413,964,2019-01-15,2,9
495,391,886,2019-01-15,2,10
478,478,956,2019-01-15,2,11
452,485,937,2019-01-15,2,12
435,501,936,2019-01-15,2,13
453,560,1013,2019-01-15,2,14
503,505,1008,2019-01-15,2,15
510,676,1186,2019-01-15,2,16
646,725,1371,2019-01-15,2,17
479,585,1064,2019-01-15,2,18
330,453,783,2019-01-15,2,19
225,293,518,2019-01-15,2,20
139,148,287,2019-01-15,2,21
95,116,211,2019-01-15,2,22
58,73,131,2019-01-15,2,23
23,33,56,2019-01-15,2,24
17,11,28,2019-01-16,3,1
11,7,18,2019-01-16,3,2
4,7,11,2019-01-16,3,3
13,9,22,2019-01-16,3,4
40,33,73,2019-01-16,3,5
203,135,338,2019-01-16,3,6
513,364,877,2019-01-16,3,7
780,537,1317,2019-01-16,3,8
516,391,907,2019-01-16,3,9
462,370,832,2019-01-16,3,10
486,430,916,2019-01-16,3,11
440,446,886,2019-01-16,3,12
476,518,994,2019-01-16,3,13
454,569,1023,2019-01-16,3,14
483,542,1025,2019-01-16,3,15
523,621,1144,2019-01-16,3,16
612,702,1314,2019-01-16,3,17
441,560,1001,2019-01-16,3,18
337,423,760,2019-01-16,3,19
197,275,472,2019-01-16,3,20
147,180,327,2019-01-16,3,21
95,129,224,2019-01-16,3,22
68,71,139,2019-01-16,3,23
32,34,66,2019-01-16,3,24
15,23,38,2019-01-17,4,1
8,10,18,2019-01-17,4,2
8,12,20,2019-01-17,4,3
12,12,24,2019-01-17,4,4
37,35,72,2019-01-17,4,5
203,137,340,2019-01-17,4,6
498,387,885,2019-01-17,4,7
820,520,1340,2019-01-17,4,8
561,393,954,2019-01-17,4,9
493,434,927,2019-01-17,4,10
457,469,926,2019-01-17,4,11
432,468,900,2019-01-17,4,12
470,540,1010,2019-01-17,4,13
486,495,981,2019-01-17,4,14
457,522,979,2019-01-17,4,15
587,646,1233,2019-01-17,4,16
669,699,1368,2019-01-17,4,17
486,592,1078,2019-01-17,4,18
315,481,796,2019-01-17,4,19
235,288,523,2019-01-17,4,20
124,174,298,2019-01-17,4,21
102,120,222,2019-01-17,4,22
75,104,179,2019-01-17,4,23
44,38,82,2019-01-17,4,24
12,21,33,2019-01-18,5,1
6,13,19,2019-01-18,5,2
13,10,23,2019-01-18,5,3
14,27,41,2019-01-18,5,4
42,37,79,2019-01-18,5,5
192,138,330,2019-01-18,5,6
468,349,817,2019-01-18,5,7
800,515,1315,2019-01-18,5,8
493,413,906,2019-01-18,5,9
473,407,880,2019-01-18,5,10
455,459,914,2019-01-18,5,11
546,521,1067,2019-01-18,5,12
595,677,1272,2019-01-18,5,13
540,639,1179,2019-01-18,5,14
631,639,1270,2019-01-18,5,15
623,612,1235,2019-01-18,5,16
589,551,1140,2019-01-18,5,17
459,496,955,2019-01-18,5,18
348,415,763,2019-01-18,5,19
237,257,494,2019-01-18,5,20
140,165,305,2019-01-18,5,21
98,115,213,2019-01-18,5,22
90,112,202,2019-01-18,5,23
58,113,171,2019-01-18,5,24
34,67,101,2019-01-19,6,1
26,23,49,2019-01-19,6,2
15,30,45,2019-01-19,6,3
13,15,28,2019-01-19,6,4
24,19,43,2019-01-19,6,5
60,39,99,2019-01-19,6,6
66,54,120,2019-01-19,6,7
111,86,197,2019-01-19,6,8
194,157,351,2019-01-19,6,9
378,261,639,2019-01-19,6,10
417,362,779,2019-01-19,6,11
486,420,906,2019-01-19,6,12
474,421,895,2019-01-19,6,13
398,442,840,2019-01-19,6,14
387,465,852,2019-01-19,6,15
314,413,727,2019-01-19,6,16
310,374,684,2019-01-19,6,17
303,359,662,2019-01-19,6,18
249,273,522,2019-01-19,6,19
176,208,384,2019-01-19,6,20
113,149,262,2019-01-19,6,21
88,105,193,2019-01-19,6,22
74,95,169,2019-01-19,6,23
61,78,139,2019-01-19,6,24
54,58,112,2019-01-20,7,1
49,35,84,2019-01-20,7,2
28,28,56,2019-01-20,7,3
17,25,42,2019-01-20,7,4
20,32,52,2019-01-20,7,5
48,33,81,2019-01-20,7,6
38,45,83,2019-01-20,7,7
36,53,89,2019-01-20,7,8
75,80,155,2019-01-20,7,9
170,143,313,2019-01-20,7,10
223,196,419,2019-01-20,7,11
316,300,616,2019-01-20,7,12
355,290,645,2019-01-20,7,13
396,396,792,2019-01-20,7,14
424,427,851,2019-01-20,7,15
363,407,770,2019-01-20,7,16
342,387,729,2019-01-20,7,17
288,316,604,2019-01-20,7,18
197,241,438,2019-01-20,7,19
152,170,322,2019-01-20,7,20
112,134,246,2019-01-20,7,21
57,85,142,2019-01-20,7,22
56,54,110,2019-01-20,7,23
24,26,50,2019-01-20,7,24
3,18,21,2019-01-21,1,1
9,5,14,2019-01-21,1,2
9,8,17,2019-01-21,1,3
13,12,25,2019-01-21,1,4
41,35,76,2019-01-21,1,5
207,160,367,2019-01-21,1,6
495,389,884,2019-01-21,1,7
826,525,1351,2019-01-21,1,8
548,429,977,2019-01-21,1,9
454,404,858,2019-01-21,1,10
454,403,857,2019-01-21,1,11
407,489,896,2019-01-21,1,12
483,524,1007,2019-01-21,1,13
484,502,986,2019-01-21,1,14
466,524,990,2019-01-21,1,15
548,619,1167,2019-01-21,1,16
634,669,1303,2019-01-21,1,17
470,604,1074,2019-01-21,1,18
332,464,796,2019-01-21,1,19
213,276,489,2019-01-21,1,20
123,155,278,2019-01-21,1,21
95,119,214,2019-01-21,1,22
35,62,97,2019-01-21,1,23
22,18,40,2019-01-21,1,24
9,14,23,2019-01-22,2,1
7,13,20,2019-01-22,2,2
14,15,29,2019-01-22,2,3
15,24,39,2019-01-22,2,4
36,45,81,2019-01-22,2,5
207,140,347,2019-01-22,2,6
496,386,882,2019-01-22,2,7
830,537,1367,2019-01-22,2,8
555,387,942,2019-01-22,2,9
440,392,832,2019-01-22,2,10
417,407,824,2019-01-22,2,11
485,469,954,2019-01-22,2,12
478,505,983,2019-01-22,2,13
447,570,1017,2019-01-22,2,14
507,548,1055,2019-01-22,2,15
549,619,1168,2019-01-22,2,16
629,768,1397,2019-01-22,2,17
455,614,1069,2019-01-22,2,18
341,454,795,2019-01-22,2,19
251,267,518,2019-01-22,2,20
146,179,325,2019-01-22,2,21
100,144,244,2019-01-22,2,22
52,79,131,2019-01-22,2,23
24,30,54,2019-01-22,2,24
9,18,27,2019-01-23,3,1
7,20,27,2019-01-23,3,2
10,7,17,2019-01-23,3,3
12,11,23,2019-01-23,3,4
34,39,73,2019-01-23,3,5
212,144,356,2019-01-23,3,6
516,374,890,2019-01-23,3,7
809,544,1353,2019-01-23,3,8
516,411,927,2019-01-23,3,9
491,371,862,2019-01-23,3,10
471,445,916,2019-01-23,3,11
446,468,914,2019-01-23,3,12
488,516,1004,2019-01-23,3,13
473,560,1033,2019-01-23,3,14
504,549,1053,2019-01-23,3,15
532,655,1187,2019-01-23,3,16
600,735,1335,2019-01-23,3,17
481,602,1083,2019-01-23,3,18
376,427,803,2019-01-23,3,19
216,228,444,2019-01-23,3,20
141,138,279,2019-01-23,3,21
74,136,210,2019-01-23,3,22
70,74,144,2019-01-23,3,23
23,33,56,2019-01-23,3,24
16,23,39,2019-01-24,4,1
10,18,28,2019-01-24,4,2
7,6,13,2019-01-24,4,3
12,15,27,2019-01-24,4,4
31,27,58,2019-01-24,4,5
189,140,329,2019-01-24,4,6
500,368,868,2019-01-24,4,7
824,499,1323,2019-01-24,4,8
550,386,936,2019-01-24,4,9
477,429,906,2019-01-24,4,10
422,418,840,2019-01-24,4,11
475,486,961,2019-01-24,4,12
474,539,1013,2019-01-24,4,13
482,562,1044,2019-01-24,4,14
467,520,987,2019-01-24,4,15
521,642,1163,2019-01-24,4,16
685,757,1442,2019-01-24,4,17
480,601,1081,2019-01-24,4,18
331,436,767,2019-01-24,4,19
234,310,544,2019-01-24,4,20
156,204,360,2019-01-24,4,21
119,116,235,2019-01-24,4,22
65,86,151,2019-01-24,4,23
30,36,66,2019-01-24,4,24
11,21,32,2019-01-25,5,1
13,18,31,2019-01-25,5,2
5,11,16,2019-01-25,5,3
14,8,22,2019-01-25,5,4
38,32,70,2019-01-25,5,5
189,139,328,2019-01-25,5,6
456,342,798,2019-01-25,5,7
768,481,1249,2019-01-25,5,8
524,389,913,2019-01-25,5,9
462,406,868,2019-01-25,5,10
494,462,956,2019-01-25,5,11
542,608,1150,2019-01-25,5,12
597,687,1284,2019-01-25,5,13
528,657,1185,2019-01-25,5,14
534,610,1144,2019-01-25,5,15
514,585,1099,2019-01-25,5,16
472,573,1045,2019-01-25,5,17
398,461,859,2019-01-25,5,18
342,398,740,2019-01-25,5,19
271,233,504,2019-01-25,5,20
151,179,330,2019-01-25,5,21
83,117,200,2019-01-25,5,22
98,109,207,2019-01-25,5,23
49,96,145,2019-01-25,5,24
39,66,105,2019-01-26,6,1
25,30,55,2019-01-26,6,2
12,20,32,2019-01-26,6,3
20,19,39,2019-01-26,6,4
24,37,61,2019-01-26,6,5
64,52,116,2019-01-26,6,6
57,58,115,2019-01-26,6,7
122,99,221,2019-01-26,6,8
199,144,343,2019-01-26,6,9
289,224,513,2019-01-26,6,10
413,336,749,2019-01-26,6,11
433,400,833,2019-01-26,6,12
416,421,837,2019-01-26,6,13
377,447,824,2019-01-26,6,14
365,432,797,2019-01-26,6,15
300,360,660,2019-01-26,6,16
322,346,668,2019-01-26,6,17
306,300,606,2019-01-26,6,18
219,248,467,2019-01-26,6,19
151,203,354,2019-01-26,6,20
102,146,248,2019-01-26,6,21
74,103,177,2019-01-26,6,22
99,70,169,2019-01-26,6,23
63,88,151,2019-01-26,6,24
61,35,96,2019-01-27,7,1
50,32,82,2019-01-27,7,2
22,24,46,2019-01-27,7,3
27,25,52,2019-01-27,7,4
19,20,39,2019-01-27,7,5
45,40,85,2019-01-27,7,6
35,43,78,2019-01-27,7,7
41,38,79,2019-01-27,7,8
99,64,163,2019-01-27,7,9
155,155,310,2019-01-27,7,10
198,217,415,2019-01-27,7,11
265,271,536,2019-01-27,7,12
307,308,615,2019-01-27,7,13
304,298,602,2019-01-27,7,14
299,304,603,2019-01-27,7,15
239,292,531,2019-01-27,7,16
287,298,585,2019-01-27,7,17
292,283,575,2019-01-27,7,18
182,216,398,2019-01-27,7,19
149,150,299,2019-01-27,7,20
103,110,213,2019-01-27,7,21
71,81,152,2019-01-27,7,22
39,63,102,2019-01-27,7,23
25,37,62,2019-01-27,7,24
12,22,34,2019-01-28,1,1
9,13,22,2019-01-28,1,2
6,9,15,2019-01-28,1,3
15,17,32,2019-01-28,1,4
38,42,80,2019-01-28,1,5
211,141,352,2019-01-28,1,6
491,352,843,2019-01-28,1,7
818,529,1347,2019-01-28,1,8
509,395,904,2019-01-28,1,9
481,415,896,2019-01-28,1,10
469,444,913,2019-01-28,1,11
472,471,943,2019-01-28,1,12
492,520,1012,2019-01-28,1,13
505,507,1012,2019-01-28,1,14
456,473,929,2019-01-28,1,15
559,670,1229,2019-01-28,1,16
592,720,1312,2019-01-28,1,17
428,556,984,2019-01-28,1,18
302,459,761,2019-01-28,1,19
206,249,455,2019-01-28,1,20
131,140,271,2019-01-28,1,21
90,113,203,2019-01-28,1,22
60,69,129,2019-01-28,1,23
22,26,48,2019-01-28,1,24
15,16,31,2019-01-29,2,1
10,12,22,2019-01-29,2,2
8,8,16,2019-01-29,2,3
13,19,32,2019-01-29,2,4
42,39,81,2019-01-29,2,5
190,135,325,2019-01-29,2,6
513,367,880,2019-01-29,2,7
816,484,1300,2019-01-29,2,8
492,395,887,2019-01-29,2,9
483,393,876,2019-01-29,2,10
428,434,862,2019-01-29,2,11
456,442,898,2019-01-29,2,12
467,475,942,2019-01-29,2,13
477,555,1032,2019-01-29,2,14
488,508,996,2019-01-29,2,15
524,657,1181,2019-01-29,2,16
624,720,1344,2019-01-29,2,17
484,632,1116,2019-01-29,2,18
350,418,768,2019-01-29,2,19
225,284,509,2019-01-29,2,20
130,186,316,2019-01-29,2,21
96,132,228,2019-01-29,2,22
41,71,112,2019-01-29,2,23
21,46,67,2019-01-29,2,24
20,14,34,2019-01-30,3,1
10,6,16,2019-01-30,3,2
3,8,11,2019-01-30,3,3
16,16,32,2019-01-30,3,4
36,41,77,2019-01-30,3,5
211,116,327,2019-01-30,3,6
494,367,861,2019-01-30,3,7
759,539,1298,2019-01-30,3,8
559,393,952,2019-01-30,3,9
478,390,868,2019-01-30,3,10
418,421,839,2019-01-30,3,11
454,469,923,2019-01-30,3,12
507,541,1048,2019-01-30,3,13
444,521,965,2019-01-30,3,14
474,520,994,2019-01-30,3,15
520,683,1203,2019-01-30,3,16
620,714,1334,2019-01-30,3,17
495,606,1101,2019-01-30,3,18
306,421,727,2019-01-30,3,19
210,236,446,2019-01-30,3,20
148,168,316,2019-01-30,3,21
89,114,203,2019-01-30,3,22
50,79,129,2019-01-30,3,23
19,40,59,2019-01-30,3,24
22,19,41,2019-01-31,4,1
9,11,20,2019-01-31,4,2
7,11,18,2019-01-31,4,3
13,14,27,2019-01-31,4,4
46,45,91,2019-01-31,4,5
204,151,355,2019-01-31,4,6
481,355,836,2019-01-31,4,7
817,510,1327,2019-01-31,4,8
558,416,974,2019-01-31,4,9
455,407,862,2019-01-31,4,10
479,450,929,2019-01-31,4,11
446,475,921,2019-01-31,4,12
474,542,1016,2019-01-31,4,13
486,594,1080,2019-01-31,4,14
513,572,1085,2019-01-31,4,15
578,623,1201,2019-01-31,4,16
637,727,1364,2019-01-31,4,17
482,664,1146,2019-01-31,4,18
335,498,833,2019-01-31,4,19
247,262,509,2019-01-31,4,20
153,166,319,2019-01-31,4,21
106,153,259,2019-01-31,4,22
69,80,149,2019-01-31,4,23
28,43,71,2019-01-31,4,24
13,15,28,2019-02-01,5,1
7,14,21,2019-02-01,5,2
8,10,18,2019-02-01,5,3
11,7,18,2019-02-01,5,4
52,46,98,2019-02-01,5,5
189,127,316,2019-02-01,5,6
446,327,773,2019-02-01,5,7
723,496,1219,2019-02-01,5,8
541,375,916,2019-02-01,5,9
477,404,881,2019-02-01,5,10
460,501,961,2019-02-01,5,11
528,563,1091,2019-02-01,5,12
614,657,1271,2019-02-01,5,13
596,660,1256,2019-02-01,5,14
590,653,1243,2019-02-01,5,15
508,614,1122,2019-02-01,5,16
498,567,1065,2019-02-01,5,17
406,483,889,2019-02-01,5,18
364,398,762,2019-02-01,5,19
215,245,460,2019-02-01,5,20
132,178,310,2019-02-01,5,21
95,149,244,2019-02-01,5,22
74,117,191,2019-02-01,5,23
37,73,110,2019-02-01,5,24
38,46,84,2019-02-02,6,1
24,26,50,2019-02-02,6,2
21,23,44,2019-02-02,6,3
21,20,41,2019-02-02,6,4
24,18,42,2019-02-02,6,5
71,55,126,2019-02-02,6,6
61,45,106,2019-02-02,6,7
114,91,205,2019-02-02,6,8
232,153,385,2019-02-02,6,9
374,276,650,2019-02-02,6,10
443,346,789,2019-02-02,6,11
466,447,913,2019-02-02,6,12
428,505,933,2019-02-02,6,13
406,485,891,2019-02-02,6,14
407,436,843,2019-02-02,6,15
362,390,752,2019-02-02,6,16
342,370,712,2019-02-02,6,17
326,338,664,2019-02-02,6,18
249,280,529,2019-02-02,6,19
142,212,354,2019-02-02,6,20
102,154,256,2019-02-02,6,21
100,124,224,2019-02-02,6,22
77,100,177,2019-02-02,6,23
44,73,117,2019-02-02,6,24
48,40,88,2019-02-03,7,1
35,39,74,2019-02-03,7,2
20,24,44,2019-02-03,7,3
23,21,44,2019-02-03,7,4
17,17,34,2019-02-03,7,5
60,29,89,2019-02-03,7,6
45,41,86,2019-02-03,7,7
60,49,109,2019-02-03,7,8
97,65,162,2019-02-03,7,9
213,167,380,2019-02-03,7,10
361,257,618,2019-02-03,7,11
544,389,933,2019-02-03,7,12
622,431,1053,2019-02-03,7,13
524,516,1040,2019-02-03,7,14
487,624,1111,2019-02-03,7,15
335,516,851,2019-02-03,7,16
303,528,831,2019-02-03,7,17
358,420,778,2019-02-03,7,18
238,258,496,2019-02-03,7,19
143,172,315,2019-02-03,7,20
134,145,279,2019-02-03,7,21
70,88,158,2019-02-03,7,22
32,52,84,2019-02-03,7,23
24,22,46,2019-02-03,7,24
9,20,29,2019-02-04,1,1
9,12,21,2019-02-04,1,2
9,10,19,2019-02-04,1,3
12,8,20,2019-02-04,1,4
45,48,93,2019-02-04,1,5
219,152,371,2019-02-04,1,6
459,394,853,2019-02-04,1,7
826,542,1368,2019-02-04,1,8
561,400,961,2019-02-04,1,9
463,420,883,2019-02-04,1,10
474,446,920,2019-02-04,1,11
472,468,940,2019-02-04,1,12
475,546,1021,2019-02-04,1,13
437,510,947,2019-02-04,1,14
505,490,995,2019-02-04,1,15
580,660,1240,2019-02-04,1,16
606,719,1325,2019-02-04,1,17
514,594,1108,2019-02-04,1,18
329,433,762,2019-02-04,1,19
206,262,468,2019-02-04,1,20
152,153,305,2019-02-04,1,21
94,120,214,2019-02-04,1,22
41,62,103,2019-02-04,1,23
20,19,39,2019-02-04,1,24
9,14,23,2019-02-05,2,1
10,13,23,2019-02-05,2,2
12,11,23,2019-02-05,2,3
13,13,26,2019-02-05,2,4
39,33,72,2019-02-05,2,5
197,131,328,2019-02-05,2,6
487,391,878,2019-02-05,2,7
838,515,1353,2019-02-05,2,8
526,414,940,2019-02-05,2,9
488,388,876,2019-02-05,2,10
447,409,856,2019-02-05,2,11
436,481,917,2019-02-05,2,12
477,503,980,2019-02-05,2,13
464,522,986,2019-02-05,2,14
517,531,1048,2019-02-05,2,15
523,607,1130,2019-02-05,2,16
697,735,1432,2019-02-05,2,17
493,595,1088,2019-02-05,2,18
330,436,766,2019-02-05,2,19
247,279,526,2019-02-05,2,20
128,180,308,2019-02-05,2,21
91,143,234,2019-02-05,2,22
44,80,124,2019-02-05,2,23
23,31,54,2019-02-05,2,24
13,18,31,2019-02-06,3,1
11,6,17,2019-02-06,3,2
8,9,17,2019-02-06,3,3
12,9,21,2019-02-06,3,4
38,34,72,2019-02-06,3,5
190,117,307,2019-02-06,3,6
506,384,890,2019-02-06,3,7
798,553,1351,2019-02-06,3,8
594,407,1001,2019-02-06,3,9
501,407,908,2019-02-06,3,10
425,461,886,2019-02-06,3,11
484,495,979,2019-02-06,3,12
462,545,1007,2019-02-06,3,13
438,529,967,2019-02-06,3,14
468,506,974,2019-02-06,3,15
495,646,1141,2019-02-06,3,16
698,654,1352,2019-02-06,3,17
468,552,1020,2019-02-06,3,18
331,444,775,2019-02-06,3,19
218,267,485,2019-02-06,3,20
141,180,321,2019-02-06,3,21
88,181,269,2019-02-06,3,22
69,72,141,2019-02-06,3,23
34,32,66,2019-02-06,3,24
17,17,34,2019-02-07,4,1
10,13,23,2019-02-07,4,2
9,4,13,2019-02-07,4,3
11,12,23,2019-02-07,4,4
31,30,61,2019-02-07,4,5
196,148,344,2019-02-07,4,6
491,372,863,2019-02-07,4,7
822,496,1318,2019-02-07,4,8
558,412,970,2019-02-07,4,9
472,407,879,2019-02-07,4,10
453,432,885,2019-02-07,4,11
447,431,878,2019-02-07,4,12
448,526,974,2019-02-07,4,13
520,545,1065,2019-02-07,4,14
520,539,1059,2019-02-07,4,15
552,651,1203,2019-02-07,4,16
695,717,1412,2019-02-07,4,17
540,578,1118,2019-02-07,4,18
332,521,853,2019-02-07,4,19
219,294,513,2019-02-07,4,20
166,200,366,2019-02-07,4,21
121,120,241,2019-02-07,4,22
60,76,136,2019-02-07,4,23
21,41,62,2019-02-07,4,24
15,18,33,2019-02-08,5,1
14,12,26,2019-02-08,5,2
7,7,14,2019-02-08,5,3
11,8,19,2019-02-08,5,4
40,36,76,2019-02-08,5,5
194,124,318,2019-02-08,5,6
444,358,802,2019-02-08,5,7
801,483,1284,2019-02-08,5,8
506,419,925,2019-02-08,5,9
468,382,850,2019-02-08,5,10
468,430,898,2019-02-08,5,11
553,598,1151,2019-02-08,5,12
623,616,1239,2019-02-08,5,13
536,676,1212,2019-02-08,5,14
552,588,1140,2019-02-08,5,15
507,544,1051,2019-02-08,5,16
485,553,1038,2019-02-08,5,17
395,450,845,2019-02-08,5,18
303,406,709,2019-02-08,5,19
219,230,449,2019-02-08,5,20
137,172,309,2019-02-08,5,21
121,118,239,2019-02-08,5,22
78,128,206,2019-02-08,5,23
50,71,121,2019-02-08,5,24
57,41,98,2019-02-09,6,1
22,25,47,2019-02-09,6,2
22,18,40,2019-02-09,6,3
13,14,27,2019-02-09,6,4
20,24,44,2019-02-09,6,5
61,44,105,2019-02-09,6,6
64,54,118,2019-02-09,6,7
115,96,211,2019-02-09,6,8
243,162,405,2019-02-09,6,9
365,279,644,2019-02-09,6,10
474,396,870,2019-02-09,6,11
482,405,887,2019-02-09,6,12
406,420,826,2019-02-09,6,13
395,457,852,2019-02-09,6,14
372,438,810,2019-02-09,6,15
318,354,672,2019-02-09,6,16
306,296,602,2019-02-09,6,17
348,326,674,2019-02-09,6,18
254,268,522,2019-02-09,6,19
191,180,371,2019-02-09,6,20
127,147,274,2019-02-09,6,21
78,112,190,2019-02-09,6,22
57,97,154,2019-02-09,6,23
41,64,105,2019-02-09,6,24
52,62,114,2019-02-10,7,1
28,39,67,2019-02-10,7,2
22,25,47,2019-02-10,7,3
20,23,43,2019-02-10,7,4
30,29,59,2019-02-10,7,5
52,43,95,2019-02-10,7,6
40,44,84,2019-02-10,7,7
61,49,110,2019-02-10,7,8
111,86,197,2019-02-10,7,9
181,169,350,2019-02-10,7,10
255,245,500,2019-02-10,7,11
282,346,628,2019-02-10,7,12
325,280,605,2019-02-10,7,13
275,349,624,2019-02-10,7,14
320,362,682,2019-02-10,7,15
305,292,597,2019-02-10,7,16
315,295,610,2019-02-10,7,17
294,262,556,2019-02-10,7,18
208,219,427,2019-02-10,7,19
158,162,320,2019-02-10,7,20
120,150,270,2019-02-10,7,21
55,94,149,2019-02-10,7,22
43,54,97,2019-02-10,7,23
16,25,41,2019-02-10,7,24
14,12,26,2019-02-11,1,1
5,9,14,2019-02-11,1,2
6,11,17,2019-02-11,1,3
7,7,14,2019-02-11,1,4
47,30,77,2019-02-11,1,5
204,156,360,2019-02-11,1,6
480,389,869,2019-02-11,1,7
825,510,1335,2019-02-11,1,8
554,395,949,2019-02-11,1,9
507,406,913,2019-02-11,1,10
500,471,971,2019-02-11,1,11
496,536,1032,2019-02-11,1,12
472,532,1004,2019-02-11,1,13
541,539,1080,2019-02-11,1,14
494,533,1027,2019-02-11,1,15
570,680,1250,2019-02-11,1,16
715,715,1430,2019-02-11,1,17
504,652,1156,2019-02-11,1,18
325,470,795,2019-02-11,1,19
230,268,498,2019-02-11,1,20
145,159,304,2019-02-11,1,21
111,101,212,2019-02-11,1,22
41,65,106,2019-02-11,1,23
20,23,43,2019-02-11,1,24
13,18,31,2019-02-12,2,1
12,8,20,2019-02-12,2,2
11,9,20,2019-02-12,2,3
5,11,16,2019-02-12,2,4
31,33,64,2019-02-12,2,5
202,131,333,2019-02-12,2,6
464,369,833,2019-02-12,2,7
812,533,1345,2019-02-12,2,8
561,451,1012,2019-02-12,2,9
492,373,865,2019-02-12,2,10
485,504,989,2019-02-12,2,11
485,476,961,2019-02-12,2,12
477,475,952,2019-02-12,2,13
500,564,1064,2019-02-12,2,14
539,556,1095,2019-02-12,2,15
561,670,1231,2019-02-12,2,16
719,724,1443,2019-02-12,2,17
481,592,1073,2019-02-12,2,18
333,483,816,2019-02-12,2,19
229,273,502,2019-02-12,2,20
139,167,306,2019-02-12,2,21
126,104,230,2019-02-12,2,22
43,91,134,2019-02-12,2,23
36,37,73,2019-02-12,2,24
11,14,25,2019-02-13,3,1
14,15,29,2019-02-13,3,2
7,10,17,2019-02-13,3,3
12,16,28,2019-02-13,3,4
37,30,67,2019-02-13,3,5
179,129,308,2019-02-13,3,6
493,376,869,2019-02-13,3,7
795,534,1329,2019-02-13,3,8
551,380,931,2019-02-13,3,9
460,393,853,2019-02-13,3,10
473,471,944,2019-02-13,3,11
452,480,932,2019-02-13,3,12
479,537,1016,2019-02-13,3,13
476,608,1084,2019-02-13,3,14
482,605,1087,2019-02-13,3,15
588,656,1244,2019-02-13,3,16
587,736,1323,2019-02-13,3,17
512,595,1107,2019-02-13,3,18
358,411,769,2019-02-13,3,19
224,253,477,2019-02-13,3,20
149,196,345,2019-02-13,3,21
94,129,223,2019-02-13,3,22
66,90,156,2019-02-13,3,23
31,39,70,2019-02-13,3,24
22,19,41,2019-02-14,4,1
12,8,20,2019-02-14,4,2
5,10,15,2019-02-14,4,3
10,13,23,2019-02-14,4,4
39,28,67,2019-02-14,4,5
170,143,313,2019-02-14,4,6
488,373,861,2019-02-14,4,7
839,511,1350,2019-02-14,4,8
532,417,949,2019-02-14,4,9
480,420,900,2019-02-14,4,10
484,465,949,2019-02-14,4,11
471,504,975,2019-02-14,4,12
505,537,1042,2019-02-14,4,13
538,558,1096,2019-02-14,4,14
561,583,1144,2019-02-14,4,15
629,669,1298,2019-02-14,4,16
660,758,1418,2019-02-14,4,17
528,629,1157,2019-02-14,4,18
329,509,838,2019-02-14,4,19
251,285,536,2019-02-14,4,20
159,188,347,2019-02-14,4,21
134,137,271,2019-02-14,4,22
78,100,178,2019-02-14,4,23
27,41,68,2019-02-14,4,24
3,13,16,2019-02-15,5,1
11,11,22,2019-02-15,5,2
9,9,18,2019-02-15,5,3
9,16,25,2019-02-15,5,4
39,26,65,2019-02-15,5,5
97,74,171,2019-02-15,5,6
430,330,760,2019-02-15,5,7
787,506,1293,2019-02-15,5,8
539,424,963,2019-02-15,5,9
465,408,873,2019-02-15,5,10
470,514,984,2019-02-15,5,11
589,589,1178,2019-02-15,5,12
691,665,1356,2019-02-15,5,13
667,737,1404,2019-02-15,5,14
623,642,1265,2019-02-15,5,15
551,640,1191,2019-02-15,5,16
542,593,1135,2019-02-15,5,17
428,493,921,2019-02-15,5,18
353,436,789,2019-02-15,5,19
250,282,532,2019-02-15,5,20
114,162,276,2019-02-15,5,21
117,159,276,2019-02-15,5,22
75,118,193,2019-02-15,5,23
66,62,128,2019-02-15,5,24
39,36,75,2019-02-16,6,1
29,32,61,2019-02-16,6,2
12,20,32,2019-02-16,6,3
13,18,31,2019-02-16,6,4
16,8,24,2019-02-16,6,5
55,59,114,2019-02-16,6,6
61,45,106,2019-02-16,6,7
115,104,219,2019-02-16,6,8
242,192,434,2019-02-16,6,9
388,346,734,2019-02-16,6,10
549,410,959,2019-02-16,6,11
507,556,1063,2019-02-16,6,12
546,472,1018,2019-02-16,6,13
480,460,940,2019-02-16,6,14
490,543,1033,2019-02-16,6,15
386,482,868,2019-02-16,6,16
360,457,817,2019-02-16,6,17
389,390,779,2019-02-16,6,18
286,310,596,2019-02-16,6,19
184,205,389,2019-02-16,6,20
131,150,281,2019-02-16,6,21
93,114,207,2019-02-16,6,22
63,99,162,2019-02-16,6,23
48,73,121,2019-02-16,6,24
46,56,102,2019-02-17,7,1
48,44,92,2019-02-17,7,2
19,21,40,2019-02-17,7,3
19,22,41,2019-02-17,7,4
22,18,40,2019-02-17,7,5
37,44,81,2019-02-17,7,6
50,40,90,2019-02-17,7,7
62,57,119,2019-02-17,7,8
104,85,189,2019-02-17,7,9
213,206,419,2019-02-17,7,10
284,292,576,2019-02-17,7,11
403,355,758,2019-02-17,7,12
486,353,839,2019-02-17,7,13
499,399,898,2019-02-17,7,14
428,477,905,2019-02-17,7,15
408,474,882,2019-02-17,7,16
340,528,868,2019-02-17,7,17
356,419,775,2019-02-17,7,18
226,222,448,2019-02-17,7,19
172,171,343,2019-02-17,7,20
96,138,234,2019-02-17,7,21
59,84,143,2019-02-17,7,22
44,57,101,2019-02-17,7,23
18,34,52,2019-02-17,7,24
11,24,35,2019-02-18,1,1
8,12,20,2019-02-18,1,2
9,11,20,2019-02-18,1,3
11,11,22,2019-02-18,1,4
35,37,72,2019-02-18,1,5
216,146,362,2019-02-18,1,6
279,231,510,2019-02-18,1,7
843,503,1346,2019-02-18,1,8
556,436,992,2019-02-18,1,9
550,409,959,2019-02-18,1,10
494,453,947,2019-02-18,1,11
471,499,970,2019-02-18,1,12
481,520,1001,2019-02-18,1,13
514,613,1127,2019-02-18,1,14
559,552,1111,2019-02-18,1,15
613,689,1302,2019-02-18,1,16
688,726,1414,2019-02-18,1,17
515,636,1151,2019-02-18,1,18
348,472,820,2019-02-18,1,19
228,287,515,2019-02-18,1,20
143,151,294,2019-02-18,1,21
83,147,230,2019-02-18,1,22
46,80,126,2019-02-18,1,23
20,31,51,2019-02-18,1,24
12,19,31,2019-02-19,2,1
7,12,19,2019-02-19,2,2
10,4,14,2019-02-19,2,3
11,15,26,2019-02-19,2,4
33,27,60,2019-02-19,2,5
204,140,344,2019-02-19,2,6
518,401,919,2019-02-19,2,7
853,517,1370,2019-02-19,2,8
530,437,967,2019-02-19,2,9
507,451,958,2019-02-19,2,10
452,456,908,2019-02-19,2,11
442,439,881,2019-02-19,2,12
415,511,926,2019-02-19,2,13
512,565,1077,2019-02-19,2,14
497,552,1049,2019-02-19,2,15
584,696,1280,2019-02-19,2,16
667,744,1411,2019-02-19,2,17
521,637,1158,2019-02-19,2,18
334,455,789,2019-02-19,2,19
236,285,521,2019-02-19,2,20
153,177,330,2019-02-19,2,21
104,131,235,2019-02-19,2,22
45,60,105,2019-02-19,2,23
26,34,60,2019-02-19,2,24
17,15,32,2019-02-20,3,1
6,11,17,2019-02-20,3,2
5,5,10,2019-02-20,3,3
11,14,25,2019-02-20,3,4
39,29,68,2019-02-20,3,5
186,139,325,2019-02-20,3,6
505,358,863,2019-02-20,3,7
830,521,1351,2019-02-20,3,8
585,450,1035,2019-02-20,3,9
499,401,900,2019-02-20,3,10
453,464,917,2019-02-20,3,11
467,542,1009,2019-02-20,3,12
464,563,1027,2019-02-20,3,13
490,508,998,2019-02-20,3,14
500,540,1040,2019-02-20,3,15
547,640,1187,2019-02-20,3,16
632,756,1388,2019-02-20,3,17
498,599,1097,2019-02-20,3,18
379,395,774,2019-02-20,3,19
223,256,479,2019-02-20,3,20
125,161,286,2019-02-20,3,21
87,158,245,2019-02-20,3,22
48,56,104,2019-02-20,3,23
31,36,67,2019-02-20,3,24
20,13,33,2019-02-21,4,1
9,15,24,2019-02-21,4,2
11,5,16,2019-02-21,4,3
12,15,27,2019-02-21,4,4
45,31,76,2019-02-21,4,5
198,143,341,2019-02-21,4,6
485,385,870,2019-02-21,4,7
833,532,1365,2019-02-21,4,8
558,429,987,2019-02-21,4,9
464,416,880,2019-02-21,4,10
452,465,917,2019-02-21,4,11
450,487,937,2019-02-21,4,12
452,504,956,2019-02-21,4,13
481,611,1092,2019-02-21,4,14
521,527,1048,2019-02-21,4,15
548,660,1208,2019-02-21,4,16
691,708,1399,2019-02-21,4,17
508,590,1098,2019-02-21,4,18
393,480,873,2019-02-21,4,19
210,311,521,2019-02-21,4,20
163,189,352,2019-02-21,4,21
104,146,250,2019-02-21,4,22
87,86,173,2019-02-21,4,23
35,36,71,2019-02-21,4,24
20,21,41,2019-02-22,5,1
9,9,18,2019-02-22,5,2
8,10,18,2019-02-22,5,3
11,13,24,2019-02-22,5,4
46,33,79,2019-02-22,5,5
186,121,307,2019-02-22,5,6
475,365,840,2019-02-22,5,7
800,545,1345,2019-02-22,5,8
522,390,912,2019-02-22,5,9
498,433,931,2019-02-22,5,10
506,491,997,2019-02-22,5,11
566,524,1090,2019-02-22,5,12
592,678,1270,2019-02-22,5,13
522,754,1276,2019-02-22,5,14
580,643,1223,2019-02-22,5,15
549,608,1157,2019-02-22,5,16
520,580,1100,2019-02-22,5,17
413,500,913,2019-02-22,5,18
340,439,779,2019-02-22,5,19
215,335,550,2019-02-22,5,20
153,176,329,2019-02-22,5,21
119,139,258,2019-02-22,5,22
83,83,166,2019-02-22,5,23
51,62,113,2019-02-22,5,24
32,39,71,2019-02-23,6,1
22,28,50,2019-02-23,6,2
15,12,27,2019-02-23,6,3
16,12,28,2019-02-23,6,4
21,16,37,2019-02-23,6,5
58,42,100,2019-02-23,6,6
78,64,142,2019-02-23,6,7
79,60,139,2019-02-23,6,8
253,177,430,2019-02-23,6,9
438,344,782,2019-02-23,6,10
503,432,935,2019-02-23,6,11
528,481,1009,2019-02-23,6,12
513,459,972,2019-02-23,6,13
438,463,901,2019-02-23,6,14
454,492,946,2019-02-23,6,15
351,437,788,2019-02-23,6,16
367,458,825,2019-02-23,6,17
391,387,778,2019-02-23,6,18
305,328,633,2019-02-23,6,19
203,252,455,2019-02-23,6,20
119,153,272,2019-02-23,6,21
85,118,203,2019-02-23,6,22
77,82,159,2019-02-23,6,23
54,81,135,2019-02-23,6,24
48,48,96,2019-02-24,7,1
35,37,72,2019-02-24,7,2
18,15,33,2019-02-24,7,3
22,17,39,2019-02-24,7,4
18,22,40,2019-02-24,7,5
48,40,88,2019-02-24,7,6
39,43,82,2019-02-24,7,7
52,47,99,2019-02-24,7,8
104,112,216,2019-02-24,7,9
248,196,444,2019-02-24,7,10
316,308,624,2019-02-24,7,11
450,325,775,2019-02-24,7,12
516,372,888,2019-02-24,7,13
523,433,956,2019-02-24,7,14
514,474,988,2019-02-24,7,15
389,519,908,2019-02-24,7,16
359,543,902,2019-02-24,7,17
349,432,781,2019-02-24,7,18
230,261,491,2019-02-24,7,19
165,231,396,2019-02-24,7,20
115,152,267,2019-02-24,7,21
74,94,168,2019-02-24,7,22
39,51,90,2019-02-24,7,23
21,29,50,2019-02-24,7,24
11,19,30,2019-02-25,1,1
7,9,16,2019-02-25,1,2
3,7,10,2019-02-25,1,3
9,12,21,2019-02-25,1,4
43,42,85,2019-02-25,1,5
197,157,354,2019-02-25,1,6
496,398,894,2019-02-25,1,7
831,509,1340,2019-02-25,1,8
586,438,1024,2019-02-25,1,9
505,478,983,2019-02-25,1,10
482,438,920,2019-02-25,1,11
494,521,1015,2019-02-25,1,12
507,504,1011,2019-02-25,1,13
451,556,1007,2019-02-25,1,14
523,531,1054,2019-02-25,1,15
605,678,1283,2019-02-25,1,16
631,740,1371,2019-02-25,1,17
536,633,1169,2019-02-25,1,18
356,470,826,2019-02-25,1,19
194,274,468,2019-02-25,1,20
120,192,312,2019-02-25,1,21
87,119,206,2019-02-25,1,22
42,52,94,2019-02-25,1,23
25,14,39,2019-02-25,1,24
8,11,19,2019-02-26,2,1
8,12,20,2019-02-26,2,2
10,6,16,2019-02-26,2,3
9,9,18,2019-02-26,2,4
29,41,70,2019-02-26,2,5
209,125,334,2019-02-26,2,6
485,392,877,2019-02-26,2,7
794,513,1307,2019-02-26,2,8
570,418,988,2019-02-26,2,9
513,419,932,2019-02-26,2,10
502,549,1051,2019-02-26,2,11
470,513,983,2019-02-26,2,12
511,553,1064,2019-02-26,2,13
441,516,957,2019-02-26,2,14
568,562,1130,2019-02-26,2,15
557,725,1282,2019-02-26,2,16
684,811,1495,2019-02-26,2,17
544,651,1195,2019-02-26,2,18
354,488,842,2019-02-26,2,19
252,314,566,2019-02-26,2,20
135,167,302,2019-02-26,2,21
108,110,218,2019-02-26,2,22
39,83,122,2019-02-26,2,23
26,37,63,2019-02-26,2,24
10,17,27,2019-02-27,3,1
4,7,11,2019-02-27,3,2
9,6,15,2019-02-27,3,3
12,12,24,2019-02-27,3,4
38,33,71,2019-02-27,3,5
200,131,331,2019-02-27,3,6
517,406,923,2019-02-27,3,7
786,546,1332,2019-02-27,3,8
604,437,1041,2019-02-27,3,9
537,476,1013,2019-02-27,3,10
514,502,1016,2019-02-27,3,11
527,495,1022,2019-02-27,3,12
558,624,1182,2019-02-27,3,13
508,615,1123,2019-02-27,3,14
546,655,1201,2019-02-27,3,15
573,692,1265,2019-02-27,3,16
739,803,1542,2019-02-27,3,17
533,618,1151,2019-02-27,3,18
396,455,851,2019-02-27,3,19
244,319,563,2019-02-27,3,20
112,168,280,2019-02-27,3,21
96,136,232,2019-02-27,3,22
82,76,158,2019-02-27,3,23
29,29,58,2019-02-27,3,24
23,21,44,2019-02-28,4,1
10,7,17,2019-02-28,4,2
5,3,8,2019-02-28,4,3
12,9,21,2019-02-28,4,4
42,37,79,2019-02-28,4,5
191,135,326,2019-02-28,4,6
483,377,860,2019-02-28,4,7
851,534,1385,2019-02-28,4,8
542,432,974,2019-02-28,4,9
537,447,984,2019-02-28,4,10
512,515,1027,2019-02-28,4,11
466,464,930,2019-02-28,4,12
478,544,1022,2019-02-28,4,13
547,552,1099,2019-02-28,4,14
574,546,1120,2019-02-28,4,15
589,637,1226,2019-02-28,4,16
740,689,1429,2019-02-28,4,17
484,649,1133,2019-02-28,4,18
372,529,901,2019-02-28,4,19
231,292,523,2019-02-28,4,20
177,199,376,2019-02-28,4,21
154,152,306,2019-02-28,4,22
52,76,128,2019-02-28,4,23
31,37,68,2019-02-28,4,24
16,15,31,2019-03-01,5,1
8,11,19,2019-03-01,5,2
10,10,20,2019-03-01,5,3
9,10,19,2019-03-01,5,4
35,29,64,2019-03-01,5,5
186,142,328,2019-03-01,5,6
453,349,802,2019-03-01,5,7
768,531,1299,2019-03-01,5,8
541,409,950,2019-03-01,5,9
491,375,866,2019-03-01,5,10
494,475,969,2019-03-01,5,11
578,600,1178,2019-03-01,5,12
639,606,1245,2019-03-01,5,13
599,624,1223,2019-03-01,5,14
597,636,1233,2019-03-01,5,15
553,519,1072,2019-03-01,5,16
552,564,1116,2019-03-01,5,17
470,424,894,2019-03-01,5,18
367,434,801,2019-03-01,5,19
269,291,560,2019-03-01,5,20
138,204,342,2019-03-01,5,21
105,153,258,2019-03-01,5,22
71,121,192,2019-03-01,5,23
52,88,140,2019-03-01,5,24
35,60,95,2019-03-02,6,1
31,23,54,2019-03-02,6,2
18,22,40,2019-03-02,6,3
13,14,27,2019-03-02,6,4
20,27,47,2019-03-02,6,5
53,42,95,2019-03-02,6,6
79,62,141,2019-03-02,6,7
144,106,250,2019-03-02,6,8
63,49,112,2019-03-02,6,9
421,368,789,2019-03-02,6,10
487,463,950,2019-03-02,6,11
517,451,968,2019-03-02,6,12
483,442,925,2019-03-02,6,13
414,499,913,2019-03-02,6,14
432,452,884,2019-03-02,6,15
379,386,765,2019-03-02,6,16
361,414,775,2019-03-02,6,17
358,366,724,2019-03-02,6,18
270,287,557,2019-03-02,6,19
208,151,359,2019-03-02,6,20
143,170,313,2019-03-02,6,21
112,113,225,2019-03-02,6,22
65,89,154,2019-03-02,6,23
57,73,130,2019-03-02,6,24
50,32,82,2019-03-03,7,1
39,44,83,2019-03-03,7,2
29,24,53,2019-03-03,7,3
15,23,38,2019-03-03,7,4
21,22,43,2019-03-03,7,5
33,44,77,2019-03-03,7,6
43,48,91,2019-03-03,7,7
56,51,107,2019-03-03,7,8
124,127,251,2019-03-03,7,9
226,219,445,2019-03-03,7,10
360,281,641,2019-03-03,7,11
532,363,895,2019-03-03,7,12
570,416,986,2019-03-03,7,13
533,518,1051,2019-03-03,7,14
508,557,1065,2019-03-03,7,15
401,578,979,2019-03-03,7,16
340,491,831,2019-03-03,7,17
326,418,744,2019-03-03,7,18
222,273,495,2019-03-03,7,19
160,196,356,2019-03-03,7,20
101,128,229,2019-03-03,7,21
78,92,170,2019-03-03,7,22
44,65,109,2019-03-03,7,23
28,31,59,2019-03-03,7,24
9,14,23,2019-03-04,1,1
6,12,18,2019-03-04,1,2
6,9,15,2019-03-04,1,3
8,12,20,2019-03-04,1,4
51,38,89,2019-03-04,1,5
210,147,357,2019-03-04,1,6
500,426,926,2019-03-04,1,7
841,548,1389,2019-03-04,1,8
574,412,986,2019-03-04,1,9
527,488,1015,2019-03-04,1,10
462,479,941,2019-03-04,1,11
475,526,1001,2019-03-04,1,12
469,507,976,2019-03-04,1,13
509,555,1064,2019-03-04,1,14
494,511,1005,2019-03-04,1,15
561,678,1239,2019-03-04,1,16
643,736,1379,2019-03-04,1,17
460,618,1078,2019-03-04,1,18
351,412,763,2019-03-04,1,19
236,261,497,2019-03-04,1,20
131,143,274,2019-03-04,1,21
99,111,210,2019-03-04,1,22
53,68,121,2019-03-04,1,23
19,32,51,2019-03-04,1,24
10,10,20,2019-03-05,2,1
9,11,20,2019-03-05,2,2
7,6,13,2019-03-05,2,3
13,9,22,2019-03-05,2,4
33,35,68,2019-03-05,2,5
186,132,318,2019-03-05,2,6
500,397,897,2019-03-05,2,7
818,548,1366,2019-03-05,2,8
540,415,955,2019-03-05,2,9
479,434,913,2019-03-05,2,10
468,470,938,2019-03-05,2,11
496,477,973,2019-03-05,2,12
531,567,1098,2019-03-05,2,13
477,582,1059,2019-03-05,2,14
540,538,1078,2019-03-05,2,15
552,689,1241,2019-03-05,2,16
694,756,1450,2019-03-05,2,17
516,660,1176,2019-03-05,2,18
329,492,821,2019-03-05,2,19
234,283,517,2019-03-05,2,20
162,176,338,2019-03-05,2,21
87,99,186,2019-03-05,2,22
54,70,124,2019-03-05,2,23
32,59,91,2019-03-05,2,24
14,25,39,2019-03-06,3,1
8,9,17,2019-03-06,3,2
10,9,19,2019-03-06,3,3
7,9,16,2019-03-06,3,4
42,36,78,2019-03-06,3,5
204,128,332,2019-03-06,3,6
493,403,896,2019-03-06,3,7
791,536,1327,2019-03-06,3,8
581,459,1040,2019-03-06,3,9
519,422,941,2019-03-06,3,10
506,505,1011,2019-03-06,3,11
475,514,989,2019-03-06,3,12
510,530,1040,2019-03-06,3,13
422,561,983,2019-03-06,3,14
478,588,1066,2019-03-06,3,15
558,697,1255,2019-03-06,3,16
699,754,1453,2019-03-06,3,17
492,611,1103,2019-03-06,3,18
366,422,788,2019-03-06,3,19
236,278,514,2019-03-06,3,20
135,183,318,2019-03-06,3,21
94,126,220,2019-03-06,3,22
63,86,149,2019-03-06,3,23
29,31,60,2019-03-06,3,24
21,16,37,2019-03-07,4,1
8,12,20,2019-03-07,4,2
9,10,19,2019-03-07,4,3
12,14,26,2019-03-07,4,4
47,36,83,2019-03-07,4,5
176,139,315,2019-03-07,4,6
486,380,866,2019-03-07,4,7
848,541,1389,2019-03-07,4,8
562,444,1006,2019-03-07,4,9
508,423,931,2019-03-07,4,10
467,502,969,2019-03-07,4,11
497,485,982,2019-03-07,4,12
542,571,1113,2019-03-07,4,13
496,558,1054,2019-03-07,4,14
524,629,1153,2019-03-07,4,15
590,705,1295,2019-03-07,4,16
706,718,1424,2019-03-07,4,17
530,586,1116,2019-03-07,4,18
372,522,894,2019-03-07,4,19
304,329,633,2019-03-07,4,20
170,200,370,2019-03-07,4,21
122,145,267,2019-03-07,4,22
75,120,195,2019-03-07,4,23
26,54,80,2019-03-07,4,24
17,17,34,2019-03-08,5,1
5,6,11,2019-03-08,5,2
6,12,18,2019-03-08,5,3
10,12,22,2019-03-08,5,4
46,28,74,2019-03-08,5,5
181,130,311,2019-03-08,5,6
457,354,811,2019-03-08,5,7
776,497,1273,2019-03-08,5,8
548,430,978,2019-03-08,5,9
488,471,959,2019-03-08,5,10
512,491,1003,2019-03-08,5,11
571,574,1145,2019-03-08,5,12
639,652,1291,2019-03-08,5,13
597,676,1273,2019-03-08,5,14
618,696,1314,2019-03-08,5,15
549,630,1179,2019-03-08,5,16
519,615,1134,2019-03-08,5,17
437,528,965,2019-03-08,5,18
381,404,785,2019-03-08,5,19
276,278,554,2019-03-08,5,20
140,163,303,2019-03-08,5,21
122,129,251,2019-03-08,5,22
83,119,202,2019-03-08,5,23
64,81,145,2019-03-08,5,24
25,36,61,2019-03-09,6,1
18,35,53,2019-03-09,6,2
12,22,34,2019-03-09,6,3
16,22,38,2019-03-09,6,4
14,20,34,2019-03-09,6,5
66,51,117,2019-03-09,6,6
63,51,114,2019-03-09,6,7
141,110,251,2019-03-09,6,8
247,209,456,2019-03-09,6,9
398,371,769,2019-03-09,6,10
486,447,933,2019-03-09,6,11
500,470,970,2019-03-09,6,12
493,425,918,2019-03-09,6,13
414,506,920,2019-03-09,6,14
369,442,811,2019-03-09,6,15
342,402,744,2019-03-09,6,16
376,368,744,2019-03-09,6,17
357,336,693,2019-03-09,6,18
272,294,566,2019-03-09,6,19
183,207,390,2019-03-09,6,20
116,170,286,2019-03-09,6,21
85,136,221,2019-03-09,6,22
68,135,203,2019-03-09,6,23
62,86,148,2019-03-09,6,24
71,54,125,2019-03-10,7,1
68,36,104,2019-03-10,7,2
48,33,81,2019-03-10,7,3
40,20,60,2019-03-10,7,4
17,24,41,2019-03-10,7,5
45,40,85,2019-03-10,7,6
40,33,73,2019-03-10,7,7
48,47,95,2019-03-10,7,8
94,88,182,2019-03-10,7,9
216,230,446,2019-03-10,7,10
299,277,576,2019-03-10,7,11
307,327,634,2019-03-10,7,12
391,344,735,2019-03-10,7,13
378,367,745,2019-03-10,7,14
410,396,806,2019-03-10,7,15
335,360,695,2019-03-10,7,16
302,340,642,2019-03-10,7,17
351,339,690,2019-03-10,7,18
217,277,494,2019-03-10,7,19
133,191,324,2019-03-10,7,20
109,145,254,2019-03-10,7,21
81,93,174,2019-03-10,7,22
44,63,107,2019-03-10,7,23
19,32,51,2019-03-10,7,24
7,19,26,2019-03-11,1,1
6,10,16,2019-03-11,1,2
8,14,22,2019-03-11,1,3
8,9,17,2019-03-11,1,4
53,30,83,2019-03-11,1,5
209,150,359,2019-03-11,1,6
526,416,942,2019-03-11,1,7
804,550,1354,2019-03-11,1,8
542,397,939,2019-03-11,1,9
520,434,954,2019-03-11,1,10
496,536,1032,2019-03-11,1,11
518,491,1009,2019-03-11,1,12
510,489,999,2019-03-11,1,13
452,519,971,2019-03-11,1,14
495,523,1018,2019-03-11,1,15
543,618,1161,2019-03-11,1,16
646,794,1440,2019-03-11,1,17
500,613,1113,2019-03-11,1,18
373,454,827,2019-03-11,1,19
264,268,532,2019-03-11,1,20
136,142,278,2019-03-11,1,21
100,120,220,2019-03-11,1,22
57,83,140,2019-03-11,1,23
18,18,36,2019-03-11,1,24
13,18,31,2019-03-12,2,1
7,5,12,2019-03-12,2,2
5,11,16,2019-03-12,2,3
11,10,21,2019-03-12,2,4
37,32,69,2019-03-12,2,5
193,125,318,2019-03-12,2,6
515,395,910,2019-03-12,2,7
791,515,1306,2019-03-12,2,8
551,406,957,2019-03-12,2,9
484,444,928,2019-03-12,2,10
525,482,1007,2019-03-12,2,11
499,530,1029,2019-03-12,2,12
434,486,920,2019-03-12,2,13
431,606,1037,2019-03-12,2,14
130,122,252,2019-03-12,2,15
558,643,1201,2019-03-12,2,16
672,667,1339,2019-03-12,2,17
525,597,1122,2019-03-12,2,18
339,474,813,2019-03-12,2,19
214,272,486,2019-03-12,2,20
157,175,332,2019-03-12,2,21
92,111,203,2019-03-12,2,22
71,86,157,2019-03-12,2,23
28,33,61,2019-03-12,2,24
6,13,19,2019-03-13,3,1
9,11,20,2019-03-13,3,2
8,4,12,2019-03-13,3,3
7,9,16,2019-03-13,3,4
37,34,71,2019-03-13,3,5
200,125,325,2019-03-13,3,6
499,395,894,2019-03-13,3,7
831,553,1384,2019-03-13,3,8
551,443,994,2019-03-13,3,9
481,467,948,2019-03-13,3,10
479,504,983,2019-03-13,3,11
494,534,1028,2019-03-13,3,12
499,534,1033,2019-03-13,3,13
453,518,971,2019-03-13,3,14
510,568,1078,2019-03-13,3,15
450,657,1107,2019-03-13,3,16
643,669,1312,2019-03-13,3,17
453,567,1020,2019-03-13,3,18
357,483,840,2019-03-13,3,19
294,291,585,2019-03-13,3,20
130,154,284,2019-03-13,3,21
105,139,244,2019-03-13,3,22
72,85,157,2019-03-13,3,23
22,34,56,2019-03-13,3,24
18,18,36,2019-03-14,4,1
12,9,21,2019-03-14,4,2
12,11,23,2019-03-14,4,3
12,13,25,2019-03-14,4,4
36,29,65,2019-03-14,4,5
188,130,318,2019-03-14,4,6
487,406,893,2019-03-14,4,7
847,503,1350,2019-03-14,4,8
537,420,957,2019-03-14,4,9
504,446,950,2019-03-14,4,10
492,491,983,2019-03-14,4,11
458,483,941,2019-03-14,4,12
516,574,1090,2019-03-14,4,13
489,556,1045,2019-03-14,4,14
501,511,1012,2019-03-14,4,15
556,598,1154,2019-03-14,4,16
712,699,1411,2019-03-14,4,17
550,641,1191,2019-03-14,4,18
389,540,929,2019-03-14,4,19
234,278,512,2019-03-14,4,20
163,188,351,2019-03-14,4,21
119,170,289,2019-03-14,4,22
67,80,147,2019-03-14,4,23
41,44,85,2019-03-14,4,24
14,20,34,2019-03-15,5,1
4,8,12,2019-03-15,5,2
13,10,23,2019-03-15,5,3
9,13,22,2019-03-15,5,4
50,29,79,2019-03-15,5,5
178,130,308,2019-03-15,5,6
461,374,835,2019-03-15,5,7
764,513,1277,2019-03-15,5,8
501,438,939,2019-03-15,5,9
511,436,947,2019-03-15,5,10
508,491,999,2019-03-15,5,11
564,550,1114,2019-03-15,5,12
585,628,1213,2019-03-15,5,13
579,672,1251,2019-03-15,5,14
542,616,1158,2019-03-15,5,15
510,537,1047,2019-03-15,5,16
528,621,1149,2019-03-15,5,17
456,500,956,2019-03-15,5,18
350,446,796,2019-03-15,5,19
278,266,544,2019-03-15,5,20
129,180,309,2019-03-15,5,21
93,165,258,2019-03-15,5,22
89,120,209,2019-03-15,5,23
54,85,139,2019-03-15,5,24
24,39,63,2019-03-16,6,1
20,28,48,2019-03-16,6,2
23,25,48,2019-03-16,6,3
25,15,40,2019-03-16,6,4
24,23,47,2019-03-16,6,5
53,49,102,2019-03-16,6,6
70,70,140,2019-03-16,6,7
149,114,263,2019-03-16,6,8
288,205,493,2019-03-16,6,9
436,346,782,2019-03-16,6,10
507,448,955,2019-03-16,6,11
499,512,1011,2019-03-16,6,12
464,459,923,2019-03-16,6,13
387,419,806,2019-03-16,6,14
387,438,825,2019-03-16,6,15
373,365,738,2019-03-16,6,16
337,380,717,2019-03-16,6,17
336,366,702,2019-03-16,6,18
260,327,587,2019-03-16,6,19
226,201,427,2019-03-16,6,20
143,157,300,2019-03-16,6,21
82,105,187,2019-03-16,6,22
90,141,231,2019-03-16,6,23
71,86,157,2019-03-16,6,24
64,53,117,2019-03-17,7,1
40,51,91,2019-03-17,7,2
27,28,55,2019-03-17,7,3
33,23,56,2019-03-17,7,4
19,19,38,2019-03-17,7,5
41,36,77,2019-03-17,7,6
40,39,79,2019-03-17,7,7
37,37,74,2019-03-17,7,8
96,92,188,2019-03-17,7,9
233,208,441,2019-03-17,7,10
307,307,614,2019-03-17,7,11
317,347,664,2019-03-17,7,12
452,339,791,2019-03-17,7,13
415,402,817,2019-03-17,7,14
450,443,893,2019-03-17,7,15
380,388,768,2019-03-17,7,16
366,419,785,2019-03-17,7,17
310,386,696,2019-03-17,7,18
231,250,481,2019-03-17,7,19
165,202,367,2019-03-17,7,20
129,131,260,2019-03-17,7,21
82,82,164,2019-03-17,7,22
49,48,97,2019-03-17,7,23
13,29,42,2019-03-17,7,24
17,25,42,2019-03-18,1,1
5,12,17,2019-03-18,1,2
6,9,15,2019-03-18,1,3
11,12,23,2019-03-18,1,4
44,39,83,2019-03-18,1,5
206,186,392,2019-03-18,1,6
510,416,926,2019-03-18,1,7
807,539,1346,2019-03-18,1,8
591,448,1039,2019-03-18,1,9
526,437,963,2019-03-18,1,10
522,545,1067,2019-03-18,1,11
493,488,981,2019-03-18,1,12
468,519,987,2019-03-18,1,13
464,530,994,2019-03-18,1,14
545,573,1118,2019-03-18,1,15
577,628,1205,2019-03-18,1,16
683,705,1388,2019-03-18,1,17
546,638,1184,2019-03-18,1,18
329,487,816,2019-03-18,1,19
237,270,507,2019-03-18,1,20
143,175,318,2019-03-18,1,21
119,112,231,2019-03-18,1,22
47,67,114,2019-03-18,1,23
20,23,43,2019-03-18,1,24
11,17,28,2019-03-19,2,1
7,6,13,2019-03-19,2,2
11,12,23,2019-03-19,2,3
13,11,24,2019-03-19,2,4
28,32,60,2019-03-19,2,5
204,133,337,2019-03-19,2,6
505,387,892,2019-03-19,2,7
852,539,1391,2019-03-19,2,8
563,416,979,2019-03-19,2,9
505,478,983,2019-03-19,2,10
523,465,988,2019-03-19,2,11
519,506,1025,2019-03-19,2,12
490,539,1029,2019-03-19,2,13
485,609,1094,2019-03-19,2,14
570,564,1134,2019-03-19,2,15
600,674,1274,2019-03-19,2,16
731,726,1457,2019-03-19,2,17
513,637,1150,2019-03-19,2,18
349,503,852,2019-03-19,2,19
249,303,552,2019-03-19,2,20
177,195,372,2019-03-19,2,21
100,135,235,2019-03-19,2,22
72,84,156,2019-03-19,2,23
17,32,49,2019-03-19,2,24
17,10,27,2019-03-20,3,1
8,7,15,2019-03-20,3,2
5,15,20,2019-03-20,3,3
12,8,20,2019-03-20,3,4
36,30,66,2019-03-20,3,5
206,132,338,2019-03-20,3,6
502,380,882,2019-03-20,3,7
809,535,1344,2019-03-20,3,8
570,449,1019,2019-03-20,3,9
531,423,954,2019-03-20,3,10
521,495,1016,2019-03-20,3,11
482,537,1019,2019-03-20,3,12
518,521,1039,2019-03-20,3,13
463,539,1002,2019-03-20,3,14
504,569,1073,2019-03-20,3,15
571,632,1203,2019-03-20,3,16
702,690,1392,2019-03-20,3,17
500,625,1125,2019-03-20,3,18
387,471,858,2019-03-20,3,19
253,299,552,2019-03-20,3,20
170,172,342,2019-03-20,3,21
108,156,264,2019-03-20,3,22
63,89,152,2019-03-20,3,23
32,28,60,2019-03-20,3,24
19,21,40,2019-03-21,4,1
9,12,21,2019-03-21,4,2
5,6,11,2019-03-21,4,3
11,9,20,2019-03-21,4,4
40,37,77,2019-03-21,4,5
199,120,319,2019-03-21,4,6
507,373,880,2019-03-21,4,7
848,574,1422,2019-03-21,4,8
555,434,989,2019-03-21,4,9
470,435,905,2019-03-21,4,10
501,450,951,2019-03-21,4,11
392,434,826,2019-03-21,4,12
500,579,1079,2019-03-21,4,13
511,548,1059,2019-03-21,4,14
509,603,1112,2019-03-21,4,15
587,652,1239,2019-03-21,4,16
693,752,1445,2019-03-21,4,17
525,660,1185,2019-03-21,4,18
361,545,906,2019-03-21,4,19
235,338,573,2019-03-21,4,20
168,191,359,2019-03-21,4,21
162,122,284,2019-03-21,4,22
96,101,197,2019-03-21,4,23
39,40,79,2019-03-21,4,24
10,20,30,2019-03-22,5,1
13,12,25,2019-03-22,5,2
6,8,14,2019-03-22,5,3
13,7,20,2019-03-22,5,4
36,39,75,2019-03-22,5,5
201,112,313,2019-03-22,5,6
462,376,838,2019-03-22,5,7
784,531,1315,2019-03-22,5,8
519,446,965,2019-03-22,5,9
498,439,937,2019-03-22,5,10
545,520,1065,2019-03-22,5,11
587,599,1186,2019-03-22,5,12
663,693,1356,2019-03-22,5,13
626,757,1383,2019-03-22,5,14
595,698,1293,2019-03-22,5,15
543,601,1144,2019-03-22,5,16
545,612,1157,2019-03-22,5,17
493,518,1011,2019-03-22,5,18
388,472,860,2019-03-22,5,19
308,325,633,2019-03-22,5,20
179,235,414,2019-03-22,5,21
104,143,247,2019-03-22,5,22
97,168,265,2019-03-22,5,23
98,70,168,2019-03-22,5,24
43,44,87,2019-03-23,6,1
21,27,48,2019-03-23,6,2
18,16,34,2019-03-23,6,3
25,24,49,2019-03-23,6,4
21,25,46,2019-03-23,6,5
62,46,108,2019-03-23,6,6
83,67,150,2019-03-23,6,7
134,113,247,2019-03-23,6,8
284,218,502,2019-03-23,6,9
454,364,818,2019-03-23,6,10
517,463,980,2019-03-23,6,11
507,498,1005,2019-03-23,6,12
502,543,1045,2019-03-23,6,13
480,500,980,2019-03-23,6,14
474,504,978,2019-03-23,6,15
430,468,898,2019-03-23,6,16
377,416,793,2019-03-23,6,17
348,388,736,2019-03-23,6,18
315,343,658,2019-03-23,6,19
208,235,443,2019-03-23,6,20
149,191,340,2019-03-23,6,21
103,143,246,2019-03-23,6,22
93,116,209,2019-03-23,6,23
53,64,117,2019-03-23,6,24
49,48,97,2019-03-24,7,1
36,43,79,2019-03-24,7,2
29,24,53,2019-03-24,7,3
19,17,36,2019-03-24,7,4
19,21,40,2019-03-24,7,5
47,38,85,2019-03-24,7,6
41,39,80,2019-03-24,7,7
42,53,95,2019-03-24,7,8
136,100,236,2019-03-24,7,9
232,246,478,2019-03-24,7,10
312,262,574,2019-03-24,7,11
441,375,816,2019-03-24,7,12
447,363,810,2019-03-24,7,13
487,449,936,2019-03-24,7,14
539,483,1022,2019-03-24,7,15
443,479,922,2019-03-24,7,16
428,530,958,2019-03-24,7,17
412,522,934,2019-03-24,7,18
275,331,606,2019-03-24,7,19
220,199,419,2019-03-24,7,20
141,150,291,2019-03-24,7,21
80,97,177,2019-03-24,7,22
47,67,114,2019-03-24,7,23
14,29,43,2019-03-24,7,24
12,12,24,2019-03-25,1,1
8,10,18,2019-03-25,1,2
4,9,13,2019-03-25,1,3
13,13,26,2019-03-25,1,4
43,29,72,2019-03-25,1,5
215,145,360,2019-03-25,1,6
512,446,958,2019-03-25,1,7
800,514,1314,2019-03-25,1,8
599,455,1054,2019-03-25,1,9
540,487,1027,2019-03-25,1,10
510,497,1007,2019-03-25,1,11
492,512,1004,2019-03-25,1,12
519,479,998,2019-03-25,1,13
462,553,1015,2019-03-25,1,14
509,521,1030,2019-03-25,1,15
551,658,1209,2019-03-25,1,16
720,726,1446,2019-03-25,1,17
499,699,1198,2019-03-25,1,18
382,477,859,2019-03-25,1,19
253,296,549,2019-03-25,1,20
143,154,297,2019-03-25,1,21
97,147,244,2019-03-25,1,22
64,72,136,2019-03-25,1,23
18,29,47,2019-03-25,1,24
12,13,25,2019-03-26,2,1
9,6,15,2019-03-26,2,2
8,12,20,2019-03-26,2,3
17,12,29,2019-03-26,2,4
31,31,62,2019-03-26,2,5
199,135,334,2019-03-26,2,6
526,460,986,2019-03-26,2,7
827,541,1368,2019-03-26,2,8
609,483,1092,2019-03-26,2,9
503,498,1001,2019-03-26,2,10
528,579,1107,2019-03-26,2,11
481,522,1003,2019-03-26,2,12
493,604,1097,2019-03-26,2,13
518,644,1162,2019-03-26,2,14
574,609,1183,2019-03-26,2,15
557,766,1323,2019-03-26,2,16
762,811,1573,2019-03-26,2,17
556,718,1274,2019-03-26,2,18
382,491,873,2019-03-26,2,19
251,319,570,2019-03-26,2,20
169,187,356,2019-03-26,2,21
109,120,229,2019-03-26,2,22
52,97,149,2019-03-26,2,23
22,34,56,2019-03-26,2,24
13,14,27,2019-03-27,3,1
6,9,15,2019-03-27,3,2
8,7,15,2019-03-27,3,3
11,7,18,2019-03-27,3,4
38,31,69,2019-03-27,3,5
198,135,333,2019-03-27,3,6
495,384,879,2019-03-27,3,7
800,594,1394,2019-03-27,3,8
560,456,1016,2019-03-27,3,9
517,483,1000,2019-03-27,3,10
534,528,1062,2019-03-27,3,11
518,522,1040,2019-03-27,3,12
514,597,1111,2019-03-27,3,13
518,581,1099,2019-03-27,3,14
488,613,1101,2019-03-27,3,15
552,702,1254,2019-03-27,3,16
714,733,1447,2019-03-27,3,17
496,651,1147,2019-03-27,3,18
394,569,963,2019-03-27,3,19
238,303,541,2019-03-27,3,20
167,186,353,2019-03-27,3,21
132,132,264,2019-03-27,3,22
80,81,161,2019-03-27,3,23
22,34,56,2019-03-27,3,24
19,10,29,2019-03-28,4,1
7,12,19,2019-03-28,4,2
7,9,16,2019-03-28,4,3
12,12,24,2019-03-28,4,4
36,37,73,2019-03-28,4,5
200,145,345,2019-03-28,4,6
496,420,916,2019-03-28,4,7
834,562,1396,2019-03-28,4,8
598,503,1101,2019-03-28,4,9
544,489,1033,2019-03-28,4,10
526,513,1039,2019-03-28,4,11
462,522,984,2019-03-28,4,12
542,571,1113,2019-03-28,4,13
563,596,1159,2019-03-28,4,14
589,620,1209,2019-03-28,4,15
586,715,1301,2019-03-28,4,16
789,807,1596,2019-03-28,4,17
517,742,1259,2019-03-28,4,18
377,528,905,2019-03-28,4,19
248,325,573,2019-03-28,4,20
199,195,394,2019-03-28,4,21
122,176,298,2019-03-28,4,22
97,101,198,2019-03-28,4,23
29,41,70,2019-03-28,4,24
17,24,41,2019-03-29,5,1
5,11,16,2019-03-29,5,2
11,11,22,2019-03-29,5,3
11,9,20,2019-03-29,5,4
45,30,75,2019-03-29,5,5
192,125,317,2019-03-29,5,6
475,390,865,2019-03-29,5,7
833,526,1359,2019-03-29,5,8
577,491,1068,2019-03-29,5,9
541,465,1006,2019-03-29,5,10
603,539,1142,2019-03-29,5,11
621,665,1286,2019-03-29,5,12
671,703,1374,2019-03-29,5,13
654,781,1435,2019-03-29,5,14
675,755,1430,2019-03-29,5,15
593,644,1237,2019-03-29,5,16
576,614,1190,2019-03-29,5,17
506,568,1074,2019-03-29,5,18
440,495,935,2019-03-29,5,19
294,324,618,2019-03-29,5,20
163,199,362,2019-03-29,5,21
129,166,295,2019-03-29,5,22
105,134,239,2019-03-29,5,23
51,72,123,2019-03-29,5,24
41,46,87,2019-03-30,6,1
29,27,56,2019-03-30,6,2
14,18,32,2019-03-30,6,3
16,15,31,2019-03-30,6,4
25,22,47,2019-03-30,6,5
73,59,132,2019-03-30,6,6
92,76,168,2019-03-30,6,7
154,128,282,2019-03-30,6,8
360,287,647,2019-03-30,6,9
520,439,959,2019-03-30,6,10
628,496,1124,2019-03-30,6,11
591,548,1139,2019-03-30,6,12
583,562,1145,2019-03-30,6,13
498,588,1086,2019-03-30,6,14
513,473,986,2019-03-30,6,15
377,485,862,2019-03-30,6,16
395,468,863,2019-03-30,6,17
410,426,836,2019-03-30,6,18
318,350,668,2019-03-30,6,19
213,291,504,2019-03-30,6,20
161,192,353,2019-03-30,6,21
95,124,219,2019-03-30,6,22
77,95,172,2019-03-30,6,23
66,78,144,2019-03-30,6,24
36,54,90,2019-03-31,7,1
37,29,66,2019-03-31,7,2
0,0,0,2019-03-31,7,3
30,24,54,2019-03-31,7,4
22,36,58,2019-03-31,7,5
53,48,101,2019-03-31,7,6
45,46,91,2019-03-31,7,7
69,63,132,2019-03-31,7,8
123,110,233,2019-03-31,7,9
225,210,435,2019-03-31,7,10
333,305,638,2019-03-31,7,11
450,368,818,2019-03-31,7,12
497,446,943,2019-03-31,7,13
505,461,966,2019-03-31,7,14
534,518,1052,2019-03-31,7,15
437,551,988,2019-03-31,7,16
416,548,964,2019-03-31,7,17
360,464,824,2019-03-31,7,18
282,305,587,2019-03-31,7,19
216,252,468,2019-03-31,7,20
142,140,282,2019-03-31,7,21
89,121,210,2019-03-31,7,22
53,85,138,2019-03-31,7,23
21,45,66,2019-03-31,7,24
12,32,44,2019-04-01,1,1
6,9,15,2019-04-01,1,2
9,11,20,2019-04-01,1,3
14,12,26,2019-04-01,1,4
45,34,79,2019-04-01,1,5
169,151,320,2019-04-01,1,6
524,453,977,2019-04-01,1,7
841,551,1392,2019-04-01,1,8
576,433,1009,2019-04-01,1,9
556,453,1009,2019-04-01,1,10
518,527,1045,2019-04-01,1,11
511,532,1043,2019-04-01,1,12
526,526,1052,2019-04-01,1,13
539,606,1145,2019-04-01,1,14
504,565,1069,2019-04-01,1,15
620,700,1320,2019-04-01,1,16
731,786,1517,2019-04-01,1,17
531,639,1170,2019-04-01,1,18
425,510,935,2019-04-01,1,19
302,327,629,2019-04-01,1,20
135,193,328,2019-04-01,1,21
120,122,242,2019-04-01,1,22
46,89,135,2019-04-01,1,23
34,28,62,2019-04-01,1,24
6,13,19,2019-04-02,2,1
6,5,11,2019-04-02,2,2
10,8,18,2019-04-02,2,3
14,13,27,2019-04-02,2,4
38,31,69,2019-04-02,2,5
197,152,349,2019-04-02,2,6
542,388,930,2019-04-02,2,7
823,532,1355,2019-04-02,2,8
590,460,1050,2019-04-02,2,9
545,494,1039,2019-04-02,2,10
536,492,1028,2019-04-02,2,11
495,520,1015,2019-04-02,2,12
499,527,1026,2019-04-02,2,13
534,600,1134,2019-04-02,2,14
574,610,1184,2019-04-02,2,15
637,643,1280,2019-04-02,2,16
772,802,1574,2019-04-02,2,17
578,668,1246,2019-04-02,2,18
406,561,967,2019-04-02,2,19
255,320,575,2019-04-02,2,20
168,187,355,2019-04-02,2,21
129,166,295,2019-04-02,2,22
68,104,172,2019-04-02,2,23
34,46,80,2019-04-02,2,24
12,17,29,2019-04-03,3,1
13,12,25,2019-04-03,3,2
22,16,38,2019-04-03,3,3
27,16,43,2019-04-03,3,4
59,45,104,2019-04-03,3,5
200,137,337,2019-04-03,3,6
512,402,914,2019-04-03,3,7
830,549,1379,2019-04-03,3,8
598,452,1050,2019-04-03,3,9
527,484,1011,2019-04-03,3,10
499,497,996,2019-04-03,3,11
489,515,1004,2019-04-03,3,12
538,602,1140,2019-04-03,3,13
520,666,1186,2019-04-03,3,14
530,595,1125,2019-04-03,3,15
570,662,1232,2019-04-03,3,16
662,707,1369,2019-04-03,3,17
547,535,1082,2019-04-03,3,18
412,398,810,2019-04-03,3,19
295,297,592,2019-04-03,3,20
185,186,371,2019-04-03,3,21
119,178,297,2019-04-03,3,22
74,139,213,2019-04-03,3,23
32,28,60,2019-04-03,3,24
28,19,47,2019-04-04,4,1
8,12,20,2019-04-04,4,2
6,6,12,2019-04-04,4,3
8,8,16,2019-04-04,4,4
40,32,72,2019-04-04,4,5
185,151,336,2019-04-04,4,6
488,372,860,2019-04-04,4,7
722,485,1207,2019-04-04,4,8
529,444,973,2019-04-04,4,9
548,461,1009,2019-04-04,4,10
515,492,1007,2019-04-04,4,11
543,516,1059,2019-04-04,4,12
488,561,1049,2019-04-04,4,13
549,521,1070,2019-04-04,4,14
612,608,1220,2019-04-04,4,15
585,679,1264,2019-04-04,4,16
776,750,1526,2019-04-04,4,17
536,723,1259,2019-04-04,4,18
429,536,965,2019-04-04,4,19
265,334,599,2019-04-04,4,20
194,188,382,2019-04-04,4,21
114,170,284,2019-04-04,4,22
83,95,178,2019-04-04,4,23
28,39,67,2019-04-04,4,24
21,17,38,2019-04-05,5,1
6,13,19,2019-04-05,5,2
11,12,23,2019-04-05,5,3
16,15,31,2019-04-05,5,4
49,36,85,2019-04-05,5,5
170,130,300,2019-04-05,5,6
489,349,838,2019-04-05,5,7
642,476,1118,2019-04-05,5,8
494,405,899,2019-04-05,5,9
574,465,1039,2019-04-05,5,10
564,552,1116,2019-04-05,5,11
608,579,1187,2019-04-05,5,12
606,667,1273,2019-04-05,5,13
643,723,1366,2019-04-05,5,14
588,640,1228,2019-04-05,5,15
535,577,1112,2019-04-05,5,16
562,534,1096,2019-04-05,5,17
485,524,1009,2019-04-05,5,18
368,389,757,2019-04-05,5,19
236,280,516,2019-04-05,5,20
161,211,372,2019-04-05,5,21
124,127,251,2019-04-05,5,22
85,106,191,2019-04-05,5,23
53,69,122,2019-04-05,5,24
41,51,92,2019-04-06,6,1
22,25,47,2019-04-06,6,2
14,18,32,2019-04-06,6,3
17,13,30,2019-04-06,6,4
19,18,37,2019-04-06,6,5
69,43,112,2019-04-06,6,6
83,88,171,2019-04-06,6,7
153,108,261,2019-04-06,6,8
284,251,535,2019-04-06,6,9
458,413,871,2019-04-06,6,10
565,558,1123,2019-04-06,6,11
626,564,1190,2019-04-06,6,12
478,528,1006,2019-04-06,6,13
456,491,947,2019-04-06,6,14
478,470,948,2019-04-06,6,15
379,512,891,2019-04-06,6,16
359,447,806,2019-04-06,6,17
408,382,790,2019-04-06,6,18
315,347,662,2019-04-06,6,19
226,196,422,2019-04-06,6,20
174,186,360,2019-04-06,6,21
90,109,199,2019-04-06,6,22
66,97,163,2019-04-06,6,23
52,94,146,2019-04-06,6,24
50,59,109,2019-04-07,7,1
33,39,72,2019-04-07,7,2
15,23,38,2019-04-07,7,3
22,20,42,2019-04-07,7,4
16,20,36,2019-04-07,7,5
59,43,102,2019-04-07,7,6
53,46,99,2019-04-07,7,7
79,75,154,2019-04-07,7,8
141,123,264,2019-04-07,7,9
344,230,574,2019-04-07,7,10
521,322,843,2019-04-07,7,11
611,394,1005,2019-04-07,7,12
588,501,1089,2019-04-07,7,13
606,521,1127,2019-04-07,7,14
534,597,1131,2019-04-07,7,15
354,613,967,2019-04-07,7,16
361,581,942,2019-04-07,7,17
346,534,880,2019-04-07,7,18
255,396,651,2019-04-07,7,19
232,225,457,2019-04-07,7,20
146,183,329,2019-04-07,7,21
94,101,195,2019-04-07,7,22
42,48,90,2019-04-07,7,23
17,41,58,2019-04-07,7,24
9,28,37,2019-04-08,1,1
6,7,13,2019-04-08,1,2
8,10,18,2019-04-08,1,3
10,8,18,2019-04-08,1,4
44,36,80,2019-04-08,1,5
213,148,361,2019-04-08,1,6
507,405,912,2019-04-08,1,7
720,504,1224,2019-04-08,1,8
570,428,998,2019-04-08,1,9
554,496,1050,2019-04-08,1,10
574,563,1137,2019-04-08,1,11
526,568,1094,2019-04-08,1,12
585,618,1203,2019-04-08,1,13
563,643,1206,2019-04-08,1,14
587,588,1175,2019-04-08,1,15
605,693,1298,2019-04-08,1,16
705,787,1492,2019-04-08,1,17
517,651,1168,2019-04-08,1,18
357,508,865,2019-04-08,1,19
261,294,555,2019-04-08,1,20
166,203,369,2019-04-08,1,21
125,117,242,2019-04-08,1,22
52,85,137,2019-04-08,1,23
19,28,47,2019-04-08,1,24
13,16,29,2019-04-09,2,1
8,8,16,2019-04-09,2,2
7,9,16,2019-04-09,2,3
13,13,26,2019-04-09,2,4
42,38,80,2019-04-09,2,5
197,135,332,2019-04-09,2,6
521,392,913,2019-04-09,2,7
708,489,1197,2019-04-09,2,8
517,447,964,2019-04-09,2,9
557,498,1055,2019-04-09,2,10
529,536,1065,2019-04-09,2,11
546,484,1030,2019-04-09,2,12
544,552,1096,2019-04-09,2,13
556,549,1105,2019-04-09,2,14
598,614,1212,2019-04-09,2,15
635,665,1300,2019-04-09,2,16
745,809,1554,2019-04-09,2,17
533,755,1288,2019-04-09,2,18
446,578,1024,2019-04-09,2,19
312,382,694,2019-04-09,2,20
179,204,383,2019-04-09,2,21
113,136,249,2019-04-09,2,22
53,69,122,2019-04-09,2,23
30,25,55,2019-04-09,2,24
19,15,34,2019-04-10,3,1
4,13,17,2019-04-10,3,2
8,7,15,2019-04-10,3,3
11,8,19,2019-04-10,3,4
44,32,76,2019-04-10,3,5
200,133,333,2019-04-10,3,6
508,380,888,2019-04-10,3,7
683,446,1129,2019-04-10,3,8
582,483,1065,2019-04-10,3,9
616,465,1081,2019-04-10,3,10
552,590,1142,2019-04-10,3,11
603,553,1156,2019-04-10,3,12
559,625,1184,2019-04-10,3,13
599,594,1193,2019-04-10,3,14
580,667,1247,2019-04-10,3,15
593,699,1292,2019-04-10,3,16
731,774,1505,2019-04-10,3,17
561,635,1196,2019-04-10,3,18
418,503,921,2019-04-10,3,19
266,317,583,2019-04-10,3,20
196,167,363,2019-04-10,3,21
103,176,279,2019-04-10,3,22
66,84,150,2019-04-10,3,23
37,49,86,2019-04-10,3,24
28,23,51,2019-04-11,4,1
7,12,19,2019-04-11,4,2
7,7,14,2019-04-11,4,3
13,12,25,2019-04-11,4,4
38,33,71,2019-04-11,4,5
204,147,351,2019-04-11,4,6
500,380,880,2019-04-11,4,7
691,431,1122,2019-04-11,4,8
556,441,997,2019-04-11,4,9
541,476,1017,2019-04-11,4,10
510,530,1040,2019-04-11,4,11
523,551,1074,2019-04-11,4,12
594,521,1115,2019-04-11,4,13
595,600,1195,2019-04-11,4,14
601,566,1167,2019-04-11,4,15
741,706,1447,2019-04-11,4,16
894,679,1573,2019-04-11,4,17
716,672,1388,2019-04-11,4,18
574,532,1106,2019-04-11,4,19
354,312,666,2019-04-11,4,20
189,226,415,2019-04-11,4,21
111,145,256,2019-04-11,4,22
51,95,146,2019-04-11,4,23
19,35,54,2019-04-11,4,24
13,15,28,2019-04-12,5,1
9,18,27,2019-04-12,5,2
12,11,23,2019-04-12,5,3
12,9,21,2019-04-12,5,4
43,25,68,2019-04-12,5,5
177,134,311,2019-04-12,5,6
482,368,850,2019-04-12,5,7
647,396,1043,2019-04-12,5,8
530,428,958,2019-04-12,5,9
508,450,958,2019-04-12,5,10
595,557,1152,2019-04-12,5,11
602,596,1198,2019-04-12,5,12
624,655,1279,2019-04-12,5,13
742,681,1423,2019-04-12,5,14
666,668,1334,2019-04-12,5,15
624,610,1234,2019-04-12,5,16
522,550,1072,2019-04-12,5,17
512,494,1006,2019-04-12,5,18
363,440,803,2019-04-12,5,19
261,270,531,2019-04-12,5,20
229,247,476,2019-04-12,5,21
131,153,284,2019-04-12,5,22
82,98,180,2019-04-12,5,23
66,63,129,2019-04-12,5,24
39,41,80,2019-04-13,6,1
19,23,42,2019-04-13,6,2
11,17,28,2019-04-13,6,3
15,19,34,2019-04-13,6,4
20,27,47,2019-04-13,6,5
59,53,112,2019-04-13,6,6
68,79,147,2019-04-13,6,7
125,124,249,2019-04-13,6,8
246,223,469,2019-04-13,6,9
446,375,821,2019-04-13,6,10
508,424,932,2019-04-13,6,11
495,517,1012,2019-04-13,6,12
498,515,1013,2019-04-13,6,13
520,492,1012,2019-04-13,6,14
584,455,1039,2019-04-13,6,15
404,390,794,2019-04-13,6,16
345,316,661,2019-04-13,6,17
373,338,711,2019-04-13,6,18
272,311,583,2019-04-13,6,19
178,204,382,2019-04-13,6,20
118,155,273,2019-04-13,6,21
92,122,214,2019-04-13,6,22
108,87,195,2019-04-13,6,23
51,66,117,2019-04-13,6,24
42,32,74,2019-04-14,7,1
34,25,59,2019-04-14,7,2
26,24,50,2019-04-14,7,3
24,26,50,2019-04-14,7,4
16,21,37,2019-04-14,7,5
38,46,84,2019-04-14,7,6
51,39,90,2019-04-14,7,7
41,69,110,2019-04-14,7,8
91,90,181,2019-04-14,7,9
189,175,364,2019-04-14,7,10
277,302,579,2019-04-14,7,11
361,389,750,2019-04-14,7,12
482,346,828,2019-04-14,7,13
415,414,829,2019-04-14,7,14
473,453,926,2019-04-14,7,15
390,413,803,2019-04-14,7,16
341,405,746,2019-04-14,7,17
319,389,708,2019-04-14,7,18
265,328,593,2019-04-14,7,19
184,207,391,2019-04-14,7,20
133,173,306,2019-04-14,7,21
79,100,179,2019-04-14,7,22
50,61,111,2019-04-14,7,23
25,30,55,2019-04-14,7,24
17,19,36,2019-04-15,1,1
13,16,29,2019-04-15,1,2
8,10,18,2019-04-15,1,3
11,11,22,2019-04-15,1,4
44,30,74,2019-04-15,1,5
178,145,323,2019-04-15,1,6
443,365,808,2019-04-15,1,7
657,422,1079,2019-04-15,1,8
537,430,967,2019-04-15,1,9
545,486,1031,2019-04-15,1,10
535,527,1062,2019-04-15,1,11
545,508,1053,2019-04-15,1,12
516,510,1026,2019-04-15,1,13
499,516,1015,2019-04-15,1,14
530,514,1044,2019-04-15,1,15
552,587,1139,2019-04-15,1,16
661,690,1351,2019-04-15,1,17
499,628,1127,2019-04-15,1,18
372,476,848,2019-04-15,1,19
268,304,572,2019-04-15,1,20
177,189,366,2019-04-15,1,21
89,115,204,2019-04-15,1,22
53,63,116,2019-04-15,1,23
25,45,70,2019-04-15,1,24
12,17,29,2019-04-16,2,1
6,9,15,2019-04-16,2,2
12,12,24,2019-04-16,2,3
10,13,23,2019-04-16,2,4
39,35,74,2019-04-16,2,5
171,128,299,2019-04-16,2,6
472,344,816,2019-04-16,2,7
636,411,1047,2019-04-16,2,8
508,403,911,2019-04-16,2,9
537,457,994,2019-04-16,2,10
566,524,1090,2019-04-16,2,11
559,534,1093,2019-04-16,2,12
511,543,1054,2019-04-16,2,13
505,527,1032,2019-04-16,2,14
556,537,1093,2019-04-16,2,15
558,614,1172,2019-04-16,2,16
679,709,1388,2019-04-16,2,17
520,699,1219,2019-04-16,2,18
373,523,896,2019-04-16,2,19
275,302,577,2019-04-16,2,20
179,226,405,2019-04-16,2,21
112,132,244,2019-04-16,2,22
69,97,166,2019-04-16,2,23
34,34,68,2019-04-16,2,24
17,19,36,2019-04-17,3,1
10,9,19,2019-04-17,3,2
13,10,23,2019-04-17,3,3
9,9,18,2019-04-17,3,4
38,35,73,2019-04-17,3,5
168,121,289,2019-04-17,3,6
452,350,802,2019-04-17,3,7
604,451,1055,2019-04-17,3,8
578,441,1019,2019-04-17,3,9
556,475,1031,2019-04-17,3,10
594,604,1198,2019-04-17,3,11
595,605,1200,2019-04-17,3,12
526,578,1104,2019-04-17,3,13
550,580,1130,2019-04-17,3,14
559,599,1158,2019-04-17,3,15
635,687,1322,2019-04-17,3,16
737,719,1456,2019-04-17,3,17
518,649,1167,2019-04-17,3,18
417,502,919,2019-04-17,3,19
290,335,625,2019-04-17,3,20
193,215,408,2019-04-17,3,21
143,149,292,2019-04-17,3,22
62,84,146,2019-04-17,3,23
37,39,76,2019-04-17,3,24
28,29,57,2019-04-18,4,1
10,14,24,2019-04-18,4,2
11,13,24,2019-04-18,4,3
11,14,25,2019-04-18,4,4
34,32,66,2019-04-18,4,5
178,123,301,2019-04-18,4,6
446,324,770,2019-04-18,4,7
599,415,1014,2019-04-18,4,8
517,409,926,2019-04-18,4,9
591,476,1067,2019-04-18,4,10
625,567,1192,2019-04-18,4,11
632,644,1276,2019-04-18,4,12
596,633,1229,2019-04-18,4,13
648,582,1230,2019-04-18,4,14
668,640,1308,2019-04-18,4,15
700,728,1428,2019-04-18,4,16
680,763,1443,2019-04-18,4,17
548,636,1184,2019-04-18,4,18
464,572,1036,2019-04-18,4,19
329,404,733,2019-04-18,4,20
222,259,481,2019-04-18,4,21
139,151,290,2019-04-18,4,22
112,130,242,2019-04-18,4,23
71,75,146,2019-04-18,4,24
34,35,69,2019-04-19,5,1
21,23,44,2019-04-19,5,2
16,12,28,2019-04-19,5,3
19,17,36,2019-04-19,5,4
24,17,41,2019-04-19,5,5
40,42,82,2019-04-19,5,6
50,48,98,2019-04-19,5,7
66,64,130,2019-04-19,5,8
124,137,261,2019-04-19,5,9
295,263,558,2019-04-19,5,10
396,471,867,2019-04-19,5,11
378,461,839,2019-04-19,5,12
435,472,907,2019-04-19,5,13
492,449,941,2019-04-19,5,14
551,457,1008,2019-04-19,5,15
468,436,904,2019-04-19,5,16
452,500,952,2019-04-19,5,17
422,509,931,2019-04-19,5,18
361,358,719,2019-04-19,5,19
236,258,494,2019-04-19,5,20
182,202,384,2019-04-19,5,21
112,138,250,2019-04-19,5,22
63,86,149,2019-04-19,5,23
45,52,97,2019-04-19,5,24
37,35,72,2019-04-20,6,1
17,24,41,2019-04-20,6,2
19,19,38,2019-04-20,6,3
11,15,26,2019-04-20,6,4
22,17,39,2019-04-20,6,5
77,52,129,2019-04-20,6,6
91,65,156,2019-04-20,6,7
201,132,333,2019-04-20,6,8
387,288,675,2019-04-20,6,9
600,513,1113,2019-04-20,6,10
714,592,1306,2019-04-20,6,11
733,613,1346,2019-04-20,6,12
602,592,1194,2019-04-20,6,13
488,533,1021,2019-04-20,6,14
493,581,1074,2019-04-20,6,15
392,548,940,2019-04-20,6,16
388,532,920,2019-04-20,6,17
394,470,864,2019-04-20,6,18
305,380,685,2019-04-20,6,19
249,264,513,2019-04-20,6,20
182,225,407,2019-04-20,6,21
137,162,299,2019-04-20,6,22
92,111,203,2019-04-20,6,23
72,76,148,2019-04-20,6,24
45,45,90,2019-04-21,7,1
27,30,57,2019-04-21,7,2
17,18,35,2019-04-21,7,3
14,12,26,2019-04-21,7,4
15,15,30,2019-04-21,7,5
50,42,92,2019-04-21,7,6
45,30,75,2019-04-21,7,7
63,73,136,2019-04-21,7,8
118,159,277,2019-04-21,7,9
302,345,647,2019-04-21,7,10
407,458,865,2019-04-21,7,11
474,450,924,2019-04-21,7,12
539,424,963,2019-04-21,7,13
565,384,949,2019-04-21,7,14
474,453,927,2019-04-21,7,15
492,490,982,2019-04-21,7,16
424,486,910,2019-04-21,7,17
457,526,983,2019-04-21,7,18
364,429,793,2019-04-21,7,19
283,294,577,2019-04-21,7,20
209,245,454,2019-04-21,7,21
152,154,306,2019-04-21,7,22
84,111,195,2019-04-21,7,23
50,33,83,2019-04-21,7,24
25,26,51,2019-04-22,1,1
28,25,53,2019-04-22,1,2
17,15,32,2019-04-22,1,3
9,16,25,2019-04-22,1,4
17,16,33,2019-04-22,1,5
49,55,104,2019-04-22,1,6
36,23,59,2019-04-22,1,7
72,80,152,2019-04-22,1,8
101,116,217,2019-04-22,1,9
228,259,487,2019-04-22,1,10
467,462,929,2019-04-22,1,11
576,514,1090,2019-04-22,1,12
520,486,1006,2019-04-22,1,13
594,527,1121,2019-04-22,1,14
608,633,1241,2019-04-22,1,15
473,650,1123,2019-04-22,1,16
415,601,1016,2019-04-22,1,17
480,561,1041,2019-04-22,1,18
346,403,749,2019-04-22,1,19
274,275,549,2019-04-22,1,20
193,190,383,2019-04-22,1,21
74,107,181,2019-04-22,1,22
44,69,113,2019-04-22,1,23
16,29,45,2019-04-22,1,24
5,15,20,2019-04-23,2,1
8,9,17,2019-04-23,2,2
10,11,21,2019-04-23,2,3
11,12,23,2019-04-23,2,4
47,37,84,2019-04-23,2,5
186,159,345,2019-04-23,2,6
542,398,940,2019-04-23,2,7
850,555,1405,2019-04-23,2,8
563,454,1017,2019-04-23,2,9
538,455,993,2019-04-23,2,10
510,496,1006,2019-04-23,2,11
508,515,1023,2019-04-23,2,12
528,547,1075,2019-04-23,2,13
620,669,1289,2019-04-23,2,14
580,553,1133,2019-04-23,2,15
595,663,1258,2019-04-23,2,16
727,756,1483,2019-04-23,2,17
589,689,1278,2019-04-23,2,18
393,535,928,2019-04-23,2,19
286,334,620,2019-04-23,2,20
184,194,378,2019-04-23,2,21
138,136,274,2019-04-23,2,22
81,102,183,2019-04-23,2,23
19,42,61,2019-04-23,2,24
16,27,43,2019-04-24,3,1
7,16,23,2019-04-24,3,2
11,15,26,2019-04-24,3,3
11,10,21,2019-04-24,3,4
50,30,80,2019-04-24,3,5
189,162,351,2019-04-24,3,6
526,397,923,2019-04-24,3,7
785,537,1322,2019-04-24,3,8
606,440,1046,2019-04-24,3,9
549,440,989,2019-04-24,3,10
560,523,1083,2019-04-24,3,11
579,591,1170,2019-04-24,3,12
512,610,1122,2019-04-24,3,13
584,665,1249,2019-04-24,3,14
522,607,1129,2019-04-24,3,15
629,695,1324,2019-04-24,3,16
742,732,1474,2019-04-24,3,17
565,652,1217,2019-04-24,3,18
419,513,932,2019-04-24,3,19
306,330,636,2019-04-24,3,20
218,251,469,2019-04-24,3,21
104,133,237,2019-04-24,3,22
66,92,158,2019-04-24,3,23
27,39,66,2019-04-24,3,24
18,25,43,2019-04-25,4,1
8,14,22,2019-04-25,4,2
11,18,29,2019-04-25,4,3
13,10,23,2019-04-25,4,4
54,32,86,2019-04-25,4,5
196,156,352,2019-04-25,4,6
504,376,880,2019-04-25,4,7
862,547,1409,2019-04-25,4,8
539,443,982,2019-04-25,4,9
558,488,1046,2019-04-25,4,10
530,545,1075,2019-04-25,4,11
593,542,1135,2019-04-25,4,12
546,578,1124,2019-04-25,4,13
595,617,1212,2019-04-25,4,14
575,597,1172,2019-04-25,4,15
708,708,1416,2019-04-25,4,16
754,773,1527,2019-04-25,4,17
564,685,1249,2019-04-25,4,18
447,562,1009,2019-04-25,4,19
252,366,618,2019-04-25,4,20
224,242,466,2019-04-25,4,21
131,185,316,2019-04-25,4,22
83,96,179,2019-04-25,4,23
40,76,116,2019-04-25,4,24
13,26,39,2019-04-26,5,1
7,10,17,2019-04-26,5,2
12,12,24,2019-04-26,5,3
10,12,22,2019-04-26,5,4
49,33,82,2019-04-26,5,5
180,146,326,2019-04-26,5,6
502,371,873,2019-04-26,5,7
745,472,1217,2019-04-26,5,8
585,472,1057,2019-04-26,5,9
600,503,1103,2019-04-26,5,10
552,564,1116,2019-04-26,5,11
601,574,1175,2019-04-26,5,12
632,667,1299,2019-04-26,5,13
619,701,1320,2019-04-26,5,14
680,656,1336,2019-04-26,5,15
638,634,1272,2019-04-26,5,16
601,611,1212,2019-04-26,5,17
517,517,1034,2019-04-26,5,18
433,494,927,2019-04-26,5,19
317,318,635,2019-04-26,5,20
203,224,427,2019-04-26,5,21
129,168,297,2019-04-26,5,22
84,120,204,2019-04-26,5,23
56,96,152,2019-04-26,5,24
30,38,68,2019-04-27,6,1
25,31,56,2019-04-27,6,2
13,19,32,2019-04-27,6,3
17,20,37,2019-04-27,6,4
26,24,50,2019-04-27,6,5
60,47,107,2019-04-27,6,6
95,85,180,2019-04-27,6,7
197,129,326,2019-04-27,6,8
335,243,578,2019-04-27,6,9
462,413,875,2019-04-27,6,10
588,493,1081,2019-04-27,6,11
546,513,1059,2019-04-27,6,12
527,505,1032,2019-04-27,6,13
470,520,990,2019-04-27,6,14
475,473,948,2019-04-27,6,15
367,409,776,2019-04-27,6,16
374,444,818,2019-04-27,6,17
373,401,774,2019-04-27,6,18
345,379,724,2019-04-27,6,19
223,283,506,2019-04-27,6,20
181,238,419,2019-04-27,6,21
125,219,344,2019-04-27,6,22
127,129,256,2019-04-27,6,23
98,94,192,2019-04-27,6,24
91,50,141,2019-04-28,7,1
103,62,165,2019-04-28,7,2
91,45,136,2019-04-28,7,3
42,37,79,2019-04-28,7,4
30,23,53,2019-04-28,7,5
48,43,91,2019-04-28,7,6
43,48,91,2019-04-28,7,7
81,80,161,2019-04-28,7,8
147,90,237,2019-04-28,7,9
264,237,501,2019-04-28,7,10
310,293,603,2019-04-28,7,11
344,362,706,2019-04-28,7,12
463,407,870,2019-04-28,7,13
426,423,849,2019-04-28,7,14
453,425,878,2019-04-28,7,15
417,459,876,2019-04-28,7,16
332,446,778,2019-04-28,7,17
386,405,791,2019-04-28,7,18
265,293,558,2019-04-28,7,19
184,228,412,2019-04-28,7,20
138,147,285,2019-04-28,7,21
81,117,198,2019-04-28,7,22
54,56,110,2019-04-28,7,23
26,53,79,2019-04-28,7,24
11,22,33,2019-04-29,1,1
10,15,25,2019-04-29,1,2
12,15,27,2019-04-29,1,3
13,9,22,2019-04-29,1,4
52,37,89,2019-04-29,1,5
197,162,359,2019-04-29,1,6
526,439,965,2019-04-29,1,7
861,531,1392,2019-04-29,1,8
605,472,1077,2019-04-29,1,9
543,494,1037,2019-04-29,1,10
577,545,1122,2019-04-29,1,11
548,572,1120,2019-04-29,1,12
545,583,1128,2019-04-29,1,13
550,536,1086,2019-04-29,1,14
553,583,1136,2019-04-29,1,15
660,695,1355,2019-04-29,1,16
749,767,1516,2019-04-29,1,17
537,620,1157,2019-04-29,1,18
432,559,991,2019-04-29,1,19
313,347,660,2019-04-29,1,20
189,215,404,2019-04-29,1,21
126,155,281,2019-04-29,1,22
75,88,163,2019-04-29,1,23
32,39,71,2019-04-29,1,24
13,21,34,2019-04-30,2,1
6,9,15,2019-04-30,2,2
9,7,16,2019-04-30,2,3
13,13,26,2019-04-30,2,4
48,33,81,2019-04-30,2,5
201,136,337,2019-04-30,2,6
493,381,874,2019-04-30,2,7
833,489,1322,2019-04-30,2,8
647,487,1134,2019-04-30,2,9
579,498,1077,2019-04-30,2,10
622,565,1187,2019-04-30,2,11
578,578,1156,2019-04-30,2,12
534,597,1131,2019-04-30,2,13
561,673,1234,2019-04-30,2,14
643,611,1254,2019-04-30,2,15
750,711,1461,2019-04-30,2,16
790,729,1519,2019-04-30,2,17
630,685,1315,2019-04-30,2,18
448,506,954,2019-04-30,2,19
353,408,761,2019-04-30,2,20
213,234,447,2019-04-30,2,21
156,192,348,2019-04-30,2,22
96,117,213,2019-04-30,2,23
68,84,152,2019-04-30,2,24
46,50,96,2019-05-01,3,1
36,39,75,2019-05-01,3,2
37,25,62,2019-05-01,3,3
26,26,52,2019-05-01,3,4
28,23,51,2019-05-01,3,5
56,51,107,2019-05-01,3,6
49,55,104,2019-05-01,3,7
71,64,135,2019-05-01,3,8
110,102,212,2019-05-01,3,9
207,200,407,2019-05-01,3,10
335,364,699,2019-05-01,3,11
355,417,772,2019-05-01,3,12
368,420,788,2019-05-01,3,13
380,428,808,2019-05-01,3,14
437,432,869,2019-05-01,3,15
371,383,754,2019-05-01,3,16
337,348,685,2019-05-01,3,17
392,320,712,2019-05-01,3,18
264,299,563,2019-05-01,3,19
220,206,426,2019-05-01,3,20
167,170,337,2019-05-01,3,21
92,92,184,2019-05-01,3,22
52,47,99,2019-05-01,3,23
34,37,71,2019-05-01,3,24
16,19,35,2019-05-02,4,1
12,10,22,2019-05-02,4,2
9,18,27,2019-05-02,4,3
13,11,24,2019-05-02,4,4
41,28,69,2019-05-02,4,5
202,123,325,2019-05-02,4,6
480,336,816,2019-05-02,4,7
791,513,1304,2019-05-02,4,8
611,490,1101,2019-05-02,4,9
616,478,1094,2019-05-02,4,10
535,536,1071,2019-05-02,4,11
505,578,1083,2019-05-02,4,12
554,567,1121,2019-05-02,4,13
532,582,1114,2019-05-02,4,14
573,623,1196,2019-05-02,4,15
606,669,1275,2019-05-02,4,16
677,697,1374,2019-05-02,4,17
522,652,1174,2019-05-02,4,18
424,537,961,2019-05-02,4,19
254,351,605,2019-05-02,4,20
197,224,421,2019-05-02,4,21
137,158,295,2019-05-02,4,22
82,76,158,2019-05-02,4,23
32,40,72,2019-05-02,4,24
17,21,38,2019-05-03,5,1
4,11,15,2019-05-03,5,2
8,22,30,2019-05-03,5,3
14,11,25,2019-05-03,5,4
45,31,76,2019-05-03,5,5
196,121,317,2019-05-03,5,6
457,318,775,2019-05-03,5,7
771,472,1243,2019-05-03,5,8
557,429,986,2019-05-03,5,9
534,485,1019,2019-05-03,5,10
599,562,1161,2019-05-03,5,11
582,612,1194,2019-05-03,5,12
651,676,1327,2019-05-03,5,13
611,634,1245,2019-05-03,5,14
611,644,1255,2019-05-03,5,15
605,601,1206,2019-05-03,5,16
588,632,1220,2019-05-03,5,17
483,527,1010,2019-05-03,5,18
430,456,886,2019-05-03,5,19
273,310,583,2019-05-03,5,20
174,189,363,2019-05-03,5,21
119,187,306,2019-05-03,5,22
77,126,203,2019-05-03,5,23
62,75,137,2019-05-03,5,24
26,34,60,2019-05-04,6,1
19,20,39,2019-05-04,6,2
19,19,38,2019-05-04,6,3
16,18,34,2019-05-04,6,4
20,20,40,2019-05-04,6,5
77,51,128,2019-05-04,6,6
74,61,135,2019-05-04,6,7
141,98,239,2019-05-04,6,8
303,232,535,2019-05-04,6,9
484,399,883,2019-05-04,6,10
541,467,1008,2019-05-04,6,11
546,537,1083,2019-05-04,6,12
573,547,1120,2019-05-04,6,13
404,542,946,2019-05-04,6,14
455,480,935,2019-05-04,6,15
407,409,816,2019-05-04,6,16
431,390,821,2019-05-04,6,17
371,407,778,2019-05-04,6,18
295,339,634,2019-05-04,6,19
215,234,449,2019-05-04,6,20
138,217,355,2019-05-04,6,21
137,143,280,2019-05-04,6,22
101,124,225,2019-05-04,6,23
78,83,161,2019-05-04,6,24
45,44,89,2019-05-05,7,1
37,38,75,2019-05-05,7,2
31,26,57,2019-05-05,7,3
15,26,41,2019-05-05,7,4
20,21,41,2019-05-05,7,5
50,34,84,2019-05-05,7,6
37,35,72,2019-05-05,7,7
64,77,141,2019-05-05,7,8
153,111,264,2019-05-05,7,9
317,247,564,2019-05-05,7,10
461,329,790,2019-05-05,7,11
556,447,1003,2019-05-05,7,12
520,458,978,2019-05-05,7,13
532,490,1022,2019-05-05,7,14
446,575,1021,2019-05-05,7,15
424,524,948,2019-05-05,7,16
377,569,946,2019-05-05,7,17
383,515,898,2019-05-05,7,18
275,317,592,2019-05-05,7,19
195,250,445,2019-05-05,7,20
151,150,301,2019-05-05,7,21
97,96,193,2019-05-05,7,22
53,75,128,2019-05-05,7,23
33,28,61,2019-05-05,7,24
10,22,32,2019-05-06,1,1
8,16,24,2019-05-06,1,2
6,9,15,2019-05-06,1,3
9,9,18,2019-05-06,1,4
56,39,95,2019-05-06,1,5
236,168,404,2019-05-06,1,6
552,421,973,2019-05-06,1,7
840,544,1384,2019-05-06,1,8
608,445,1053,2019-05-06,1,9
578,414,992,2019-05-06,1,10
531,550,1081,2019-05-06,1,11
512,533,1045,2019-05-06,1,12
493,558,1051,2019-05-06,1,13
516,545,1061,2019-05-06,1,14
537,501,1038,2019-05-06,1,15
602,679,1281,2019-05-06,1,16
737,602,1339,2019-05-06,1,17
552,662,1214,2019-05-06,1,18
386,537,923,2019-05-06,1,19
287,300,587,2019-05-06,1,20
151,181,332,2019-05-06,1,21
45,53,98,2019-05-06,1,22
65,89,154,2019-05-06,1,23
27,34,61,2019-05-06,1,24
10,17,27,2019-05-07,2,1
8,14,22,2019-05-07,2,2
14,11,25,2019-05-07,2,3
8,18,26,2019-05-07,2,4
45,38,83,2019-05-07,2,5
231,144,375,2019-05-07,2,6
541,423,964,2019-05-07,2,7
845,563,1408,2019-05-07,2,8
580,452,1032,2019-05-07,2,9
551,438,989,2019-05-07,2,10
490,478,968,2019-05-07,2,11
531,483,1014,2019-05-07,2,12
523,568,1091,2019-05-07,2,13
569,587,1156,2019-05-07,2,14
527,570,1097,2019-05-07,2,15
623,696,1319,2019-05-07,2,16
743,706,1449,2019-05-07,2,17
571,668,1239,2019-05-07,2,18
405,493,898,2019-05-07,2,19
272,318,590,2019-05-07,2,20
169,196,365,2019-05-07,2,21
140,151,291,2019-05-07,2,22
76,79,155,2019-05-07,2,23
25,38,63,2019-05-07,2,24
11,20,31,2019-05-08,3,1
11,19,30,2019-05-08,3,2
8,6,14,2019-05-08,3,3
8,12,20,2019-05-08,3,4
47,36,83,2019-05-08,3,5
212,154,366,2019-05-08,3,6
546,399,945,2019-05-08,3,7
842,549,1391,2019-05-08,3,8
606,458,1064,2019-05-08,3,9
545,476,1021,2019-05-08,3,10
508,464,972,2019-05-08,3,11
561,477,1038,2019-05-08,3,12
523,509,1032,2019-05-08,3,13
495,586,1081,2019-05-08,3,14
517,613,1130,2019-05-08,3,15
591,634,1225,2019-05-08,3,16
747,687,1434,2019-05-08,3,17
574,595,1169,2019-05-08,3,18
383,458,841,2019-05-08,3,19
250,290,540,2019-05-08,3,20
182,213,395,2019-05-08,3,21
106,164,270,2019-05-08,3,22
81,87,168,2019-05-08,3,23
29,38,67,2019-05-08,3,24
13,23,36,2019-05-09,4,1
6,14,20,2019-05-09,4,2
11,11,22,2019-05-09,4,3
13,17,30,2019-05-09,4,4
39,30,69,2019-05-09,4,5
244,154,398,2019-05-09,4,6
560,397,957,2019-05-09,4,7
822,540,1362,2019-05-09,4,8
596,436,1032,2019-05-09,4,9
545,494,1039,2019-05-09,4,10
511,520,1031,2019-05-09,4,11
493,509,1002,2019-05-09,4,12
485,547,1032,2019-05-09,4,13
563,581,1144,2019-05-09,4,14
552,585,1137,2019-05-09,4,15
663,643,1306,2019-05-09,4,16
731,704,1435,2019-05-09,4,17
603,590,1193,2019-05-09,4,18
374,566,940,2019-05-09,4,19
245,371,616,2019-05-09,4,20
208,253,461,2019-05-09,4,21
140,146,286,2019-05-09,4,22
90,97,187,2019-05-09,4,23
37,57,94,2019-05-09,4,24
15,17,32,2019-05-10,5,1
10,10,20,2019-05-10,5,2
7,10,17,2019-05-10,5,3
13,15,28,2019-05-10,5,4
45,30,75,2019-05-10,5,5
213,142,355,2019-05-10,5,6
532,382,914,2019-05-10,5,7
801,550,1351,2019-05-10,5,8
574,438,1012,2019-05-10,5,9
556,500,1056,2019-05-10,5,10
552,532,1084,2019-05-10,5,11
556,588,1144,2019-05-10,5,12
706,640,1346,2019-05-10,5,13
660,705,1365,2019-05-10,5,14
631,681,1312,2019-05-10,5,15
660,599,1259,2019-05-10,5,16
628,622,1250,2019-05-10,5,17
531,508,1039,2019-05-10,5,18
408,474,882,2019-05-10,5,19
288,312,600,2019-05-10,5,20
188,238,426,2019-05-10,5,21
79,87,166,2019-05-10,5,22
101,116,217,2019-05-10,5,23
61,71,132,2019-05-10,5,24
40,46,86,2019-05-11,6,1
20,26,46,2019-05-11,6,2
18,25,43,2019-05-11,6,3
18,16,34,2019-05-11,6,4
25,35,60,2019-05-11,6,5
65,53,118,2019-05-11,6,6
93,75,168,2019-05-11,6,7
204,154,358,2019-05-11,6,8
362,274,636,2019-05-11,6,9
537,416,953,2019-05-11,6,10
592,511,1103,2019-05-11,6,11
543,568,1111,2019-05-11,6,12
557,532,1089,2019-05-11,6,13
483,584,1067,2019-05-11,6,14
498,556,1054,2019-05-11,6,15
362,496,858,2019-05-11,6,16
434,479,913,2019-05-11,6,17
410,437,847,2019-05-11,6,18
377,372,749,2019-05-11,6,19
260,280,540,2019-05-11,6,20
174,216,390,2019-05-11,6,21
135,165,300,2019-05-11,6,22
84,126,210,2019-05-11,6,23
60,85,145,2019-05-11,6,24
43,59,102,2019-05-12,7,1
38,35,73,2019-05-12,7,2
24,29,53,2019-05-12,7,3
29,29,58,2019-05-12,7,4
23,27,50,2019-05-12,7,5
45,59,104,2019-05-12,7,6
42,44,86,2019-05-12,7,7
80,87,167,2019-05-12,7,8
169,144,313,2019-05-12,7,9
307,247,554,2019-05-12,7,10
410,391,801,2019-05-12,7,11
523,459,982,2019-05-12,7,12
558,530,1088,2019-05-12,7,13
603,484,1087,2019-05-12,7,14
525,556,1081,2019-05-12,7,15
414,578,992,2019-05-12,7,16
430,566,996,2019-05-12,7,17
487,567,1054,2019-05-12,7,18
358,501,859,2019-05-12,7,19
272,340,612,2019-05-12,7,20
209,222,431,2019-05-12,7,21
115,163,278,2019-05-12,7,22
69,75,144,2019-05-12,7,23
32,38,70,2019-05-12,7,24
16,26,42,2019-05-13,1,1
6,12,18,2019-05-13,1,2
6,15,21,2019-05-13,1,3
17,26,43,2019-05-13,1,4
70,44,114,2019-05-13,1,5
228,180,408,2019-05-13,1,6
570,453,1023,2019-05-13,1,7
882,541,1423,2019-05-13,1,8
671,414,1085,2019-05-13,1,9
573,452,1025,2019-05-13,1,10
565,569,1134,2019-05-13,1,11
568,510,1078,2019-05-13,1,12
560,592,1152,2019-05-13,1,13
515,601,1116,2019-05-13,1,14
591,613,1204,2019-05-13,1,15
631,731,1362,2019-05-13,1,16
754,697,1451,2019-05-13,1,17
605,722,1327,2019-05-13,1,18
441,500,941,2019-05-13,1,19
296,347,643,2019-05-13,1,20
199,205,404,2019-05-13,1,21
114,148,262,2019-05-13,1,22
66,91,157,2019-05-13,1,23
23,31,54,2019-05-13,1,24
12,14,26,2019-05-14,2,1
6,9,15,2019-05-14,2,2
13,7,20,2019-05-14,2,3
10,9,19,2019-05-14,2,4
51,38,89,2019-05-14,2,5
215,156,371,2019-05-14,2,6
582,438,1020,2019-05-14,2,7
894,545,1439,2019-05-14,2,8
607,455,1062,2019-05-14,2,9
563,487,1050,2019-05-14,2,10
560,533,1093,2019-05-14,2,11
506,518,1024,2019-05-14,2,12
527,586,1113,2019-05-14,2,13
546,624,1170,2019-05-14,2,14
574,592,1166,2019-05-14,2,15
623,713,1336,2019-05-14,2,16
799,732,1531,2019-05-14,2,17
597,638,1235,2019-05-14,2,18
402,473,875,2019-05-14,2,19
304,360,664,2019-05-14,2,20
201,211,412,2019-05-14,2,21
151,163,314,2019-05-14,2,22
76,99,175,2019-05-14,2,23
33,35,68,2019-05-14,2,24
9,19,28,2019-05-15,3,1
6,8,14,2019-05-15,3,2
12,6,18,2019-05-15,3,3
13,15,28,2019-05-15,3,4
54,36,90,2019-05-15,3,5
212,159,371,2019-05-15,3,6
594,411,1005,2019-05-15,3,7
856,458,1314,2019-05-15,3,8
620,448,1068,2019-05-15,3,9
556,438,994,2019-05-15,3,10
558,522,1080,2019-05-15,3,11
507,541,1048,2019-05-15,3,12
588,576,1164,2019-05-15,3,13
573,585,1158,2019-05-15,3,14
553,657,1210,2019-05-15,3,15
602,756,1358,2019-05-15,3,16
819,669,1488,2019-05-15,3,17
583,668,1251,2019-05-15,3,18
451,477,928,2019-05-15,3,19
290,343,633,2019-05-15,3,20
193,248,441,2019-05-15,3,21
140,183,323,2019-05-15,3,22
91,104,195,2019-05-15,3,23
30,41,71,2019-05-15,3,24
14,22,36,2019-05-16,4,1
14,14,28,2019-05-16,4,2
7,13,20,2019-05-16,4,3
9,11,20,2019-05-16,4,4
48,37,85,2019-05-16,4,5
215,144,359,2019-05-16,4,6
577,411,988,2019-05-16,4,7
856,542,1398,2019-05-16,4,8
608,458,1066,2019-05-16,4,9
603,462,1065,2019-05-16,4,10
558,505,1063,2019-05-16,4,11
542,538,1080,2019-05-16,4,12
549,588,1137,2019-05-16,4,13
568,621,1189,2019-05-16,4,14
627,573,1200,2019-05-16,4,15
632,661,1293,2019-05-16,4,16
851,714,1565,2019-05-16,4,17
595,680,1275,2019-05-16,4,18
419,692,1111,2019-05-16,4,19
295,473,768,2019-05-16,4,20
190,232,422,2019-05-16,4,21
127,159,286,2019-05-16,4,22
74,94,168,2019-05-16,4,23
41,50,91,2019-05-16,4,24
13,18,31,2019-05-17,5,1
6,8,14,2019-05-17,5,2
9,13,22,2019-05-17,5,3
10,14,24,2019-05-17,5,4
54,36,90,2019-05-17,5,5
217,129,346,2019-05-17,5,6
508,383,891,2019-05-17,5,7
842,516,1358,2019-05-17,5,8
560,453,1013,2019-05-17,5,9
508,456,964,2019-05-17,5,10
550,509,1059,2019-05-17,5,11
677,585,1262,2019-05-17,5,12
730,616,1346,2019-05-17,5,13
668,654,1322,2019-05-17,5,14
705,648,1353,2019-05-17,5,15
661,628,1289,2019-05-17,5,16
628,635,1263,2019-05-17,5,17
507,535,1042,2019-05-17,5,18
410,455,865,2019-05-17,5,19
318,326,644,2019-05-17,5,20
220,245,465,2019-05-17,5,21
143,191,334,2019-05-17,5,22
106,152,258,2019-05-17,5,23
74,72,146,2019-05-17,5,24
43,60,103,2019-05-18,6,1
25,32,57,2019-05-18,6,2
18,24,42,2019-05-18,6,3
17,15,32,2019-05-18,6,4
22,30,52,2019-05-18,6,5
59,32,91,2019-05-18,6,6
83,81,164,2019-05-18,6,7
147,134,281,2019-05-18,6,8
290,226,516,2019-05-18,6,9
463,400,863,2019-05-18,6,10
519,515,1034,2019-05-18,6,11
573,631,1204,2019-05-18,6,12
553,519,1072,2019-05-18,6,13
458,495,953,2019-05-18,6,14
481,449,930,2019-05-18,6,15
431,466,897,2019-05-18,6,16
421,409,830,2019-05-18,6,17
420,402,822,2019-05-18,6,18
347,377,724,2019-05-18,6,19
277,302,579,2019-05-18,6,20
183,224,407,2019-05-18,6,21
118,131,249,2019-05-18,6,22
95,111,206,2019-05-18,6,23
43,89,132,2019-05-18,6,24
52,71,123,2019-05-19,7,1
38,55,93,2019-05-19,7,2
23,29,52,2019-05-19,7,3
21,24,45,2019-05-19,7,4
20,23,43,2019-05-19,7,5
37,29,66,2019-05-19,7,6
35,51,86,2019-05-19,7,7
68,63,131,2019-05-19,7,8
122,133,255,2019-05-19,7,9
225,278,503,2019-05-19,7,10
339,391,730,2019-05-19,7,11
415,501,916,2019-05-19,7,12
515,454,969,2019-05-19,7,13
481,457,938,2019-05-19,7,14
529,510,1039,2019-05-19,7,15
516,500,1016,2019-05-19,7,16
488,512,1000,2019-05-19,7,17
470,526,996,2019-05-19,7,18
365,372,737,2019-05-19,7,19
256,268,524,2019-05-19,7,20
162,201,363,2019-05-19,7,21
104,129,233,2019-05-19,7,22
56,77,133,2019-05-19,7,23
18,49,67,2019-05-19,7,24
8,26,34,2019-05-20,1,1
5,13,18,2019-05-20,1,2
9,7,16,2019-05-20,1,3
10,15,25,2019-05-20,1,4
58,42,100,2019-05-20,1,5
229,181,410,2019-05-20,1,6
554,409,963,2019-05-20,1,7
871,584,1455,2019-05-20,1,8
623,454,1077,2019-05-20,1,9
542,487,1029,2019-05-20,1,10
537,563,1100,2019-05-20,1,11
562,590,1152,2019-05-20,1,12
521,582,1103,2019-05-20,1,13
533,556,1089,2019-05-20,1,14
554,632,1186,2019-05-20,1,15
616,703,1319,2019-05-20,1,16
689,793,1482,2019-05-20,1,17
531,658,1189,2019-05-20,1,18
389,482,871,2019-05-20,1,19
284,333,617,2019-05-20,1,20
184,221,405,2019-05-20,1,21
114,152,266,2019-05-20,1,22
71,69,140,2019-05-20,1,23
17,32,49,2019-05-20,1,24
9,15,24,2019-05-21,2,1
7,13,20,2019-05-21,2,2
4,6,10,2019-05-21,2,3
8,15,23,2019-05-21,2,4
57,31,88,2019-05-21,2,5
188,151,339,2019-05-21,2,6
561,396,957,2019-05-21,2,7
831,570,1401,2019-05-21,2,8
564,466,1030,2019-05-21,2,9
526,502,1028,2019-05-21,2,10
507,530,1037,2019-05-21,2,11
586,574,1160,2019-05-21,2,12
519,525,1044,2019-05-21,2,13
518,640,1158,2019-05-21,2,14
611,657,1268,2019-05-21,2,15
580,740,1320,2019-05-21,2,16
735,794,1529,2019-05-21,2,17
603,663,1266,2019-05-21,2,18
406,527,933,2019-05-21,2,19
262,324,586,2019-05-21,2,20
159,213,372,2019-05-21,2,21
157,165,322,2019-05-21,2,22
56,73,129,2019-05-21,2,23
24,24,48,2019-05-21,2,24
5,17,22,2019-05-22,3,1
12,10,22,2019-05-22,3,2
7,11,18,2019-05-22,3,3
7,13,20,2019-05-22,3,4
53,38,91,2019-05-22,3,5
206,161,367,2019-05-22,3,6
559,410,969,2019-05-22,3,7
822,556,1378,2019-05-22,3,8
604,499,1103,2019-05-22,3,9
554,480,1034,2019-05-22,3,10
506,536,1042,2019-05-22,3,11
533,572,1105,2019-05-22,3,12
504,574,1078,2019-05-22,3,13
555,582,1137,2019-05-22,3,14
598,606,1204,2019-05-22,3,15
605,711,1316,2019-05-22,3,16
758,848,1606,2019-05-22,3,17
508,678,1186,2019-05-22,3,18
419,496,915,2019-05-22,3,19
295,321,616,2019-05-22,3,20
191,202,393,2019-05-22,3,21
149,179,328,2019-05-22,3,22
81,99,180,2019-05-22,3,23
26,26,52,2019-05-22,3,24
25,17,42,2019-05-23,4,1
8,11,19,2019-05-23,4,2
8,3,11,2019-05-23,4,3
11,10,21,2019-05-23,4,4
45,37,82,2019-05-23,4,5
217,165,382,2019-05-23,4,6
570,396,966,2019-05-23,4,7
852,583,1435,2019-05-23,4,8
589,511,1100,2019-05-23,4,9
581,530,1111,2019-05-23,4,10
554,547,1101,2019-05-23,4,11
546,597,1143,2019-05-23,4,12
539,555,1094,2019-05-23,4,13
560,632,1192,2019-05-23,4,14
620,586,1206,2019-05-23,4,15
624,680,1304,2019-05-23,4,16
744,828,1572,2019-05-23,4,17
628,703,1331,2019-05-23,4,18
436,563,999,2019-05-23,4,19
292,372,664,2019-05-23,4,20
208,258,466,2019-05-23,4,21
141,154,295,2019-05-23,4,22
80,104,184,2019-05-23,4,23
41,47,88,2019-05-23,4,24
25,33,58,2019-05-24,5,1
7,11,18,2019-05-24,5,2
6,15,21,2019-05-24,5,3
7,17,24,2019-05-24,5,4
48,35,83,2019-05-24,5,5
203,155,358,2019-05-24,5,6
521,383,904,2019-05-24,5,7
787,545,1332,2019-05-24,5,8
643,508,1151,2019-05-24,5,9
557,565,1122,2019-05-24,5,10
609,644,1253,2019-05-24,5,11
648,764,1412,2019-05-24,5,12
698,813,1511,2019-05-24,5,13
684,855,1539,2019-05-24,5,14
751,801,1552,2019-05-24,5,15
705,774,1479,2019-05-24,5,16
688,729,1417,2019-05-24,5,17
607,659,1266,2019-05-24,5,18
508,608,1116,2019-05-24,5,19
352,457,809,2019-05-24,5,20
228,314,542,2019-05-24,5,21
152,222,374,2019-05-24,5,22
166,158,324,2019-05-24,5,23
80,186,266,2019-05-24,5,24
39,55,94,2019-05-25,6,1
21,33,54,2019-05-25,6,2
12,28,40,2019-05-25,6,3
22,20,42,2019-05-25,6,4
24,41,65,2019-05-25,6,5
67,74,141,2019-05-25,6,6
81,108,189,2019-05-25,6,7
182,301,483,2019-05-25,6,8
316,317,633,2019-05-25,6,9
469,510,979,2019-05-25,6,10
534,657,1191,2019-05-25,6,11
699,730,1429,2019-05-25,6,12
660,704,1364,2019-05-25,6,13
624,740,1364,2019-05-25,6,14
741,603,1344,2019-05-25,6,15
739,547,1286,2019-05-25,6,16
752,498,1250,2019-05-25,6,17
483,575,1058,2019-05-25,6,18
334,545,879,2019-05-25,6,19
274,503,777,2019-05-25,6,20
190,368,558,2019-05-25,6,21
112,234,346,2019-05-25,6,22
102,170,272,2019-05-25,6,23
74,127,201,2019-05-25,6,24
67,98,165,2019-05-26,7,1
53,66,119,2019-05-26,7,2
28,53,81,2019-05-26,7,3
26,34,60,2019-05-26,7,4
23,36,59,2019-05-26,7,5
49,56,105,2019-05-26,7,6
49,49,98,2019-05-26,7,7
58,74,132,2019-05-26,7,8
103,119,222,2019-05-26,7,9
211,238,449,2019-05-26,7,10
304,422,726,2019-05-26,7,11
377,477,854,2019-05-26,7,12
465,496,961,2019-05-26,7,13
437,491,928,2019-05-26,7,14
433,475,908,2019-05-26,7,15
416,435,851,2019-05-26,7,16
373,524,897,2019-05-26,7,17
376,463,839,2019-05-26,7,18
269,339,608,2019-05-26,7,19
191,244,435,2019-05-26,7,20
141,176,317,2019-05-26,7,21
70,116,186,2019-05-26,7,22
49,76,125,2019-05-26,7,23
19,49,68,2019-05-26,7,24
14,27,41,2019-05-27,1,1
5,14,19,2019-05-27,1,2
7,11,18,2019-05-27,1,3
8,20,28,2019-05-27,1,4
55,42,97,2019-05-27,1,5
219,195,414,2019-05-27,1,6
536,448,984,2019-05-27,1,7
839,533,1372,2019-05-27,1,8
609,452,1061,2019-05-27,1,9
576,490,1066,2019-05-27,1,10
530,582,1112,2019-05-27,1,11
541,540,1081,2019-05-27,1,12
496,589,1085,2019-05-27,1,13
509,588,1097,2019-05-27,1,14
555,560,1115,2019-05-27,1,15
632,693,1325,2019-05-27,1,16
724,793,1517,2019-05-27,1,17
532,659,1191,2019-05-27,1,18
412,490,902,2019-05-27,1,19
271,316,587,2019-05-27,1,20
197,198,395,2019-05-27,1,21
94,139,233,2019-05-27,1,22
62,98,160,2019-05-27,1,23
30,45,75,2019-05-27,1,24
21,22,43,2019-05-28,2,1
8,12,20,2019-05-28,2,2
13,9,22,2019-05-28,2,3
10,16,26,2019-05-28,2,4
41,38,79,2019-05-28,2,5
208,162,370,2019-05-28,2,6
537,385,922,2019-05-28,2,7
853,544,1397,2019-05-28,2,8
565,458,1023,2019-05-28,2,9
604,428,1032,2019-05-28,2,10
521,486,1007,2019-05-28,2,11
526,550,1076,2019-05-28,2,12
555,530,1085,2019-05-28,2,13
546,645,1191,2019-05-28,2,14
603,602,1205,2019-05-28,2,15
634,712,1346,2019-05-28,2,16
774,799,1573,2019-05-28,2,17
578,677,1255,2019-05-28,2,18
384,533,917,2019-05-28,2,19
286,334,620,2019-05-28,2,20
202,249,451,2019-05-28,2,21
121,148,269,2019-05-28,2,22
82,123,205,2019-05-28,2,23
20,34,54,2019-05-28,2,24
20,20,40,2019-05-29,3,1
13,14,27,2019-05-29,3,2
17,14,31,2019-05-29,3,3
10,10,20,2019-05-29,3,4
54,45,99,2019-05-29,3,5
202,138,340,2019-05-29,3,6
495,379,874,2019-05-29,3,7
782,555,1337,2019-05-29,3,8
649,459,1108,2019-05-29,3,9
600,530,1130,2019-05-29,3,10
596,559,1155,2019-05-29,3,11
589,631,1220,2019-05-29,3,12
587,649,1236,2019-05-29,3,13
627,645,1272,2019-05-29,3,14
594,651,1245,2019-05-29,3,15
697,744,1441,2019-05-29,3,16
729,747,1476,2019-05-29,3,17
669,688,1357,2019-05-29,3,18
494,545,1039,2019-05-29,3,19
350,385,735,2019-05-29,3,20
218,241,459,2019-05-29,3,21
128,219,347,2019-05-29,3,22
97,128,225,2019-05-29,3,23
75,76,151,2019-05-29,3,24
43,41,84,2019-05-30,4,1
38,26,64,2019-05-30,4,2
28,18,46,2019-05-30,4,3
22,9,31,2019-05-30,4,4
21,24,45,2019-05-30,4,5
39,38,77,2019-05-30,4,6
52,50,102,2019-05-30,4,7
62,72,134,2019-05-30,4,8
123,118,241,2019-05-30,4,9
267,196,463,2019-05-30,4,10
353,323,676,2019-05-30,4,11
399,370,769,2019-05-30,4,12
372,365,737,2019-05-30,4,13
421,378,799,2019-05-30,4,14
426,410,836,2019-05-30,4,15
333,332,665,2019-05-30,4,16
325,376,701,2019-05-30,4,17
303,380,683,2019-05-30,4,18
272,274,546,2019-05-30,4,19
241,181,422,2019-05-30,4,20
153,144,297,2019-05-30,4,21
93,130,223,2019-05-30,4,22
73,82,155,2019-05-30,4,23
47,45,92,2019-05-30,4,24
21,27,48,2019-05-31,5,1
22,22,44,2019-05-31,5,2
24,34,58,2019-05-31,5,3
14,17,31,2019-05-31,5,4
38,38,76,2019-05-31,5,5
93,82,175,2019-05-31,5,6
209,145,354,2019-05-31,5,7
337,230,567,2019-05-31,5,8
366,332,698,2019-05-31,5,9
544,448,992,2019-05-31,5,10
639,558,1197,2019-05-31,5,11
661,605,1266,2019-05-31,5,12
557,611,1168,2019-05-31,5,13
580,579,1159,2019-05-31,5,14
602,599,1201,2019-05-31,5,15
518,589,1107,2019-05-31,5,16
475,542,1017,2019-05-31,5,17
446,499,945,2019-05-31,5,18
348,474,822,2019-05-31,5,19
268,302,570,2019-05-31,5,20
209,227,436,2019-05-31,5,21
141,158,299,2019-05-31,5,22
106,92,198,2019-05-31,5,23
62,68,130,2019-05-31,5,24
41,50,91,2019-06-01,6,1
19,28,47,2019-06-01,6,2
18,13,31,2019-06-01,6,3
19,17,36,2019-06-01,6,4
20,19,39,2019-06-01,6,5
55,49,104,2019-06-01,6,6
79,67,146,2019-06-01,6,7
130,111,241,2019-06-01,6,8
297,246,543,2019-06-01,6,9
487,416,903,2019-06-01,6,10
565,497,1062,2019-06-01,6,11
545,548,1093,2019-06-01,6,12
585,507,1092,2019-06-01,6,13
532,508,1040,2019-06-01,6,14
572,509,1081,2019-06-01,6,15
466,477,943,2019-06-01,6,16
403,460,863,2019-06-01,6,17
366,430,796,2019-06-01,6,18
322,350,672,2019-06-01,6,19
230,299,529,2019-06-01,6,20
204,223,427,2019-06-01,6,21
147,148,295,2019-06-01,6,22
78,108,186,2019-06-01,6,23
77,86,163,2019-06-01,6,24
47,56,103,2019-06-02,7,1
39,39,78,2019-06-02,7,2
19,22,41,2019-06-02,7,3
29,27,56,2019-06-02,7,4
30,28,58,2019-06-02,7,5
65,59,124,2019-06-02,7,6
58,55,113,2019-06-02,7,7
80,67,147,2019-06-02,7,8
151,138,289,2019-06-02,7,9
289,279,568,2019-06-02,7,10
536,405,941,2019-06-02,7,11
588,486,1074,2019-06-02,7,12
692,538,1230,2019-06-02,7,13
604,565,1169,2019-06-02,7,14
488,558,1046,2019-06-02,7,15
461,628,1089,2019-06-02,7,16
360,713,1073,2019-06-02,7,17
478,614,1092,2019-06-02,7,18
306,589,895,2019-06-02,7,19
260,302,562,2019-06-02,7,20
212,224,436,2019-06-02,7,21
107,140,247,2019-06-02,7,22
70,72,142,2019-06-02,7,23
25,36,61,2019-06-02,7,24
21,30,51,2019-06-03,1,1
10,21,31,2019-06-03,1,2
10,8,18,2019-06-03,1,3
9,14,23,2019-06-03,1,4
57,42,99,2019-06-03,1,5
236,171,407,2019-06-03,1,6
525,441,966,2019-06-03,1,7
870,574,1444,2019-06-03,1,8
585,496,1081,2019-06-03,1,9
587,568,1155,2019-06-03,1,10
552,540,1092,2019-06-03,1,11
543,575,1118,2019-06-03,1,12
519,604,1123,2019-06-03,1,13
551,570,1121,2019-06-03,1,14
582,648,1230,2019-06-03,1,15
615,713,1328,2019-06-03,1,16
725,787,1512,2019-06-03,1,17
561,697,1258,2019-06-03,1,18
402,565,967,2019-06-03,1,19
297,338,635,2019-06-03,1,20
170,209,379,2019-06-03,1,21
130,162,292,2019-06-03,1,22
72,108,180,2019-06-03,1,23
33,37,70,2019-06-03,1,24
15,16,31,2019-06-04,2,1
7,11,18,2019-06-04,2,2
12,9,21,2019-06-04,2,3
13,13,26,2019-06-04,2,4
52,33,85,2019-06-04,2,5
239,170,409,2019-06-04,2,6
595,420,1015,2019-06-04,2,7
867,548,1415,2019-06-04,2,8
608,488,1096,2019-06-04,2,9
522,457,979,2019-06-04,2,10
597,522,1119,2019-06-04,2,11
549,554,1103,2019-06-04,2,12
617,574,1191,2019-06-04,2,13
575,625,1200,2019-06-04,2,14
619,649,1268,2019-06-04,2,15
612,754,1366,2019-06-04,2,16
783,780,1563,2019-06-04,2,17
623,756,1379,2019-06-04,2,18
444,576,1020,2019-06-04,2,19
322,373,695,2019-06-04,2,20
225,242,467,2019-06-04,2,21
179,222,401,2019-06-04,2,22
100,124,224,2019-06-04,2,23
31,45,76,2019-06-04,2,24
20,32,52,2019-06-05,3,1
13,15,28,2019-06-05,3,2
7,11,18,2019-06-05,3,3
7,15,22,2019-06-05,3,4
55,35,90,2019-06-05,3,5
218,167,385,2019-06-05,3,6
586,412,998,2019-06-05,3,7
872,562,1434,2019-06-05,3,8
614,469,1083,2019-06-05,3,9
554,482,1036,2019-06-05,3,10
542,520,1062,2019-06-05,3,11
543,563,1106,2019-06-05,3,12
591,599,1190,2019-06-05,3,13
515,646,1161,2019-06-05,3,14
598,605,1203,2019-06-05,3,15
652,683,1335,2019-06-05,3,16
734,780,1514,2019-06-05,3,17
557,688,1245,2019-06-05,3,18
425,512,937,2019-06-05,3,19
290,351,641,2019-06-05,3,20
222,245,467,2019-06-05,3,21
141,182,323,2019-06-05,3,22
90,112,202,2019-06-05,3,23
27,47,74,2019-06-05,3,24
39,20,59,2019-06-06,4,1
13,17,30,2019-06-06,4,2
10,14,24,2019-06-06,4,3
9,14,23,2019-06-06,4,4
49,32,81,2019-06-06,4,5
229,155,384,2019-06-06,4,6
590,397,987,2019-06-06,4,7
864,560,1424,2019-06-06,4,8
672,476,1148,2019-06-06,4,9
587,526,1113,2019-06-06,4,10
596,532,1128,2019-06-06,4,11
536,631,1167,2019-06-06,4,12
561,621,1182,2019-06-06,4,13
569,630,1199,2019-06-06,4,14
637,644,1281,2019-06-06,4,15
711,740,1451,2019-06-06,4,16
836,794,1630,2019-06-06,4,17
624,714,1338,2019-06-06,4,18
469,579,1048,2019-06-06,4,19
299,362,661,2019-06-06,4,20
207,244,451,2019-06-06,4,21
144,179,323,2019-06-06,4,22
92,157,249,2019-06-06,4,23
40,50,90,2019-06-06,4,24
16,32,48,2019-06-07,5,1
8,9,17,2019-06-07,5,2
12,7,19,2019-06-07,5,3
10,14,24,2019-06-07,5,4
48,37,85,2019-06-07,5,5
219,156,375,2019-06-07,5,6
558,380,938,2019-06-07,5,7
796,546,1342,2019-06-07,5,8
620,490,1110,2019-06-07,5,9
613,527,1140,2019-06-07,5,10
632,550,1182,2019-06-07,5,11
655,619,1274,2019-06-07,5,12
757,750,1507,2019-06-07,5,13
706,804,1510,2019-06-07,5,14
738,658,1396,2019-06-07,5,15
707,653,1360,2019-06-07,5,16
623,588,1211,2019-06-07,5,17
557,592,1149,2019-06-07,5,18
449,569,1018,2019-06-07,5,19
308,384,692,2019-06-07,5,20
198,269,467,2019-06-07,5,21
166,196,362,2019-06-07,5,22
105,146,251,2019-06-07,5,23
66,88,154,2019-06-07,5,24
34,59,93,2019-06-08,6,1
31,35,66,2019-06-08,6,2
24,30,54,2019-06-08,6,3
11,18,29,2019-06-08,6,4
16,30,46,2019-06-08,6,5
76,59,135,2019-06-08,6,6
80,79,159,2019-06-08,6,7
140,122,262,2019-06-08,6,8
327,284,611,2019-06-08,6,9
499,410,909,2019-06-08,6,10
520,478,998,2019-06-08,6,11
557,536,1093,2019-06-08,6,12
526,517,1043,2019-06-08,6,13
497,543,1040,2019-06-08,6,14
480,526,1006,2019-06-08,6,15
424,426,850,2019-06-08,6,16
376,422,798,2019-06-08,6,17
391,389,780,2019-06-08,6,18
321,375,696,2019-06-08,6,19
239,261,500,2019-06-08,6,20
166,201,367,2019-06-08,6,21
122,166,288,2019-06-08,6,22
90,135,225,2019-06-08,6,23
67,133,200,2019-06-08,6,24
76,66,142,2019-06-09,7,1
60,43,103,2019-06-09,7,2
25,27,52,2019-06-09,7,3
20,28,48,2019-06-09,7,4
20,16,36,2019-06-09,7,5
54,48,102,2019-06-09,7,6
35,43,78,2019-06-09,7,7
67,64,131,2019-06-09,7,8
124,96,220,2019-06-09,7,9
315,260,575,2019-06-09,7,10
390,347,737,2019-06-09,7,11
539,447,986,2019-06-09,7,12
608,434,1042,2019-06-09,7,13
557,470,1027,2019-06-09,7,14
545,516,1061,2019-06-09,7,15
511,560,1071,2019-06-09,7,16
434,542,976,2019-06-09,7,17
395,496,891,2019-06-09,7,18
354,400,754,2019-06-09,7,19
298,371,669,2019-06-09,7,20
218,237,455,2019-06-09,7,21
184,161,345,2019-06-09,7,22
103,115,218,2019-06-09,7,23
70,214,284,2019-06-09,7,24
41,77,118,2019-06-10,1,1
24,39,63,2019-06-10,1,2
13,20,33,2019-06-10,1,3
13,23,36,2019-06-10,1,4
23,20,43,2019-06-10,1,5
36,37,73,2019-06-10,1,6
44,53,97,2019-06-10,1,7
57,62,119,2019-06-10,1,8
116,88,204,2019-06-10,1,9
207,217,424,2019-06-10,1,10
341,345,686,2019-06-10,1,11
416,491,907,2019-06-10,1,12
455,461,916,2019-06-10,1,13
508,496,1004,2019-06-10,1,14
563,542,1105,2019-06-10,1,15
501,515,1016,2019-06-10,1,16
413,516,929,2019-06-10,1,17
391,468,859,2019-06-10,1,18
313,358,671,2019-06-10,1,19
234,271,505,2019-06-10,1,20
168,195,363,2019-06-10,1,21
109,105,214,2019-06-10,1,22
62,78,140,2019-06-10,1,23
36,40,76,2019-06-10,1,24
13,29,42,2019-06-11,2,1
8,21,29,2019-06-11,2,2
5,10,15,2019-06-11,2,3
9,18,27,2019-06-11,2,4
52,29,81,2019-06-11,2,5
218,170,388,2019-06-11,2,6
592,444,1036,2019-06-11,2,7
835,533,1368,2019-06-11,2,8
622,467,1089,2019-06-11,2,9
512,472,984,2019-06-11,2,10
577,519,1096,2019-06-11,2,11
548,594,1142,2019-06-11,2,12
543,652,1195,2019-06-11,2,13
565,602,1167,2019-06-11,2,14
606,622,1228,2019-06-11,2,15
615,734,1349,2019-06-11,2,16
768,778,1546,2019-06-11,2,17
615,733,1348,2019-06-11,2,18
473,594,1067,2019-06-11,2,19
294,344,638,2019-06-11,2,20
193,210,403,2019-06-11,2,21
129,141,270,2019-06-11,2,22
80,113,193,2019-06-11,2,23
26,46,72,2019-06-11,2,24
16,18,34,2019-06-12,3,1
15,15,30,2019-06-12,3,2
10,10,20,2019-06-12,3,3
8,14,22,2019-06-12,3,4
52,35,87,2019-06-12,3,5
215,147,362,2019-06-12,3,6
524,393,917,2019-06-12,3,7
857,534,1391,2019-06-12,3,8
603,471,1074,2019-06-12,3,9
552,489,1041,2019-06-12,3,10
604,526,1130,2019-06-12,3,11
553,602,1155,2019-06-12,3,12
534,641,1175,2019-06-12,3,13
531,613,1144,2019-06-12,3,14
617,638,1255,2019-06-12,3,15
578,704,1282,2019-06-12,3,16
742,741,1483,2019-06-12,3,17
591,693,1284,2019-06-12,3,18
418,472,890,2019-06-12,3,19
265,315,580,2019-06-12,3,20
173,202,375,2019-06-12,3,21
118,151,269,2019-06-12,3,22
87,124,211,2019-06-12,3,23
35,36,71,2019-06-12,3,24
26,24,50,2019-06-13,4,1
9,15,24,2019-06-13,4,2
6,13,19,2019-06-13,4,3
14,17,31,2019-06-13,4,4
49,40,89,2019-06-13,4,5
229,165,394,2019-06-13,4,6
533,392,925,2019-06-13,4,7
852,548,1400,2019-06-13,4,8
649,518,1167,2019-06-13,4,9
602,508,1110,2019-06-13,4,10
616,547,1163,2019-06-13,4,11
566,582,1148,2019-06-13,4,12
567,629,1196,2019-06-13,4,13
608,632,1240,2019-06-13,4,14
648,611,1259,2019-06-13,4,15
671,763,1434,2019-06-13,4,16
725,739,1464,2019-06-13,4,17
617,743,1360,2019-06-13,4,18
453,560,1013,2019-06-13,4,19
322,353,675,2019-06-13,4,20
241,266,507,2019-06-13,4,21
179,249,428,2019-06-13,4,22
109,152,261,2019-06-13,4,23
38,58,96,2019-06-13,4,24
19,20,39,2019-06-14,5,1
12,10,22,2019-06-14,5,2
13,11,24,2019-06-14,5,3
8,10,18,2019-06-14,5,4
49,28,77,2019-06-14,5,5
238,140,378,2019-06-14,5,6
530,366,896,2019-06-14,5,7
763,507,1270,2019-06-14,5,8
615,484,1099,2019-06-14,5,9
667,552,1219,2019-06-14,5,10
626,574,1200,2019-06-14,5,11
721,674,1395,2019-06-14,5,12
738,741,1479,2019-06-14,5,13
743,780,1523,2019-06-14,5,14
680,717,1397,2019-06-14,5,15
628,627,1255,2019-06-14,5,16
671,665,1336,2019-06-14,5,17
616,629,1245,2019-06-14,5,18
448,535,983,2019-06-14,5,19
338,369,707,2019-06-14,5,20
232,275,507,2019-06-14,5,21
179,189,368,2019-06-14,5,22
135,143,278,2019-06-14,5,23
107,94,201,2019-06-14,5,24
55,58,113,2019-06-15,6,1
28,40,68,2019-06-15,6,2
28,21,49,2019-06-15,6,3
17,38,55,2019-06-15,6,4
35,32,67,2019-06-15,6,5
105,83,188,2019-06-15,6,6
98,105,203,2019-06-15,6,7
181,147,328,2019-06-15,6,8
320,271,591,2019-06-15,6,9
468,444,912,2019-06-15,6,10
496,499,995,2019-06-15,6,11
507,553,1060,2019-06-15,6,12
566,579,1145,2019-06-15,6,13
523,528,1051,2019-06-15,6,14
501,499,1000,2019-06-15,6,15
458,453,911,2019-06-15,6,16
458,416,874,2019-06-15,6,17
470,336,806,2019-06-15,6,18
344,364,708,2019-06-15,6,19
258,268,526,2019-06-15,6,20
208,222,430,2019-06-15,6,21
154,179,333,2019-06-15,6,22
109,134,243,2019-06-15,6,23
90,102,192,2019-06-15,6,24
66,66,132,2019-06-16,7,1
59,48,107,2019-06-16,7,2
23,37,60,2019-06-16,7,3
26,29,55,2019-06-16,7,4
29,29,58,2019-06-16,7,5
65,48,113,2019-06-16,7,6
44,40,84,2019-06-16,7,7
105,59,164,2019-06-16,7,8
146,126,272,2019-06-16,7,9
316,242,558,2019-06-16,7,10
408,380,788,2019-06-16,7,11
498,424,922,2019-06-16,7,12
577,447,1024,2019-06-16,7,13
550,455,1005,2019-06-16,7,14
552,522,1074,2019-06-16,7,15
501,539,1040,2019-06-16,7,16
432,540,972,2019-06-16,7,17
416,584,1000,2019-06-16,7,18
383,397,780,2019-06-16,7,19
240,279,519,2019-06-16,7,20
192,204,396,2019-06-16,7,21
108,115,223,2019-06-16,7,22
53,85,138,2019-06-16,7,23
43,51,94,2019-06-16,7,24
18,23,41,2019-06-17,1,1
7,14,21,2019-06-17,1,2
11,21,32,2019-06-17,1,3
11,22,33,2019-06-17,1,4
54,41,95,2019-06-17,1,5
237,156,393,2019-06-17,1,6
601,426,1027,2019-06-17,1,7
895,542,1437,2019-06-17,1,8
694,484,1178,2019-06-17,1,9
643,530,1173,2019-06-17,1,10
608,589,1197,2019-06-17,1,11
557,614,1171,2019-06-17,1,12
616,570,1186,2019-06-17,1,13
591,677,1268,2019-06-17,1,14
594,616,1210,2019-06-17,1,15
608,719,1327,2019-06-17,1,16
793,884,1677,2019-06-17,1,17
635,736,1371,2019-06-17,1,18
468,607,1075,2019-06-17,1,19
338,376,714,2019-06-17,1,20
197,246,443,2019-06-17,1,21
139,195,334,2019-06-17,1,22
91,98,189,2019-06-17,1,23
33,41,74,2019-06-17,1,24
27,27,54,2019-06-18,2,1
8,13,21,2019-06-18,2,2
11,23,34,2019-06-18,2,3
17,10,27,2019-06-18,2,4
51,35,86,2019-06-18,2,5
222,164,386,2019-06-18,2,6
582,397,979,2019-06-18,2,7
901,533,1434,2019-06-18,2,8
645,492,1137,2019-06-18,2,9
572,508,1080,2019-06-18,2,10
565,567,1132,2019-06-18,2,11
562,516,1078,2019-06-18,2,12
562,610,1172,2019-06-18,2,13
589,624,1213,2019-06-18,2,14
674,712,1386,2019-06-18,2,15
678,755,1433,2019-06-18,2,16
855,823,1678,2019-06-18,2,17
581,740,1321,2019-06-18,2,18
443,527,970,2019-06-18,2,19
304,320,624,2019-06-18,2,20
205,227,432,2019-06-18,2,21
133,189,322,2019-06-18,2,22
87,160,247,2019-06-18,2,23
25,53,78,2019-06-18,2,24
21,19,40,2019-06-19,3,1
9,17,26,2019-06-19,3,2
8,20,28,2019-06-19,3,3
14,18,32,2019-06-19,3,4
55,40,95,2019-06-19,3,5
247,174,421,2019-06-19,3,6
594,400,994,2019-06-19,3,7
891,548,1439,2019-06-19,3,8
642,503,1145,2019-06-19,3,9
636,468,1104,2019-06-19,3,10
558,530,1088,2019-06-19,3,11
578,580,1158,2019-06-19,3,12
611,641,1252,2019-06-19,3,13
580,621,1201,2019-06-19,3,14
589,674,1263,2019-06-19,3,15
683,739,1422,2019-06-19,3,16
813,739,1552,2019-06-19,3,17
595,645,1240,2019-06-19,3,18
454,531,985,2019-06-19,3,19
361,407,768,2019-06-19,3,20
208,242,450,2019-06-19,3,21
123,197,320,2019-06-19,3,22
88,111,199,2019-06-19,3,23
55,46,101,2019-06-19,3,24
23,25,48,2019-06-20,4,1
19,15,34,2019-06-20,4,2
8,15,23,2019-06-20,4,3
12,15,27,2019-06-20,4,4
53,32,85,2019-06-20,4,5
236,163,399,2019-06-20,4,6
633,418,1051,2019-06-20,4,7
915,557,1472,2019-06-20,4,8
651,531,1182,2019-06-20,4,9
636,516,1152,2019-06-20,4,10
583,614,1197,2019-06-20,4,11
581,616,1197,2019-06-20,4,12
616,707,1323,2019-06-20,4,13
605,653,1258,2019-06-20,4,14
651,666,1317,2019-06-20,4,15
696,688,1384,2019-06-20,4,16
811,852,1663,2019-06-20,4,17
662,724,1386,2019-06-20,4,18
483,643,1126,2019-06-20,4,19
344,398,742,2019-06-20,4,20
236,287,523,2019-06-20,4,21
167,193,360,2019-06-20,4,22
100,144,244,2019-06-20,4,23
46,52,98,2019-06-20,4,24
20,22,42,2019-06-21,5,1
10,16,26,2019-06-21,5,2
7,11,18,2019-06-21,5,3
10,18,28,2019-06-21,5,4
55,35,90,2019-06-21,5,5
206,162,368,2019-06-21,5,6
508,342,850,2019-06-21,5,7
825,537,1362,2019-06-21,5,8
566,457,1023,2019-06-21,5,9
627,498,1125,2019-06-21,5,10
587,621,1208,2019-06-21,5,11
629,612,1241,2019-06-21,5,12
713,744,1457,2019-06-21,5,13
713,727,1440,2019-06-21,5,14
653,745,1398,2019-06-21,5,15
663,666,1329,2019-06-21,5,16
663,669,1332,2019-06-21,5,17
559,581,1140,2019-06-21,5,18
437,498,935,2019-06-21,5,19
342,363,705,2019-06-21,5,20
210,239,449,2019-06-21,5,21
154,185,339,2019-06-21,5,22
119,204,323,2019-06-21,5,23
97,125,222,2019-06-21,5,24
50,97,147,2019-06-22,6,1
40,50,90,2019-06-22,6,2
23,30,53,2019-06-22,6,3
17,27,44,2019-06-22,6,4
28,36,64,2019-06-22,6,5
80,53,133,2019-06-22,6,6
88,84,172,2019-06-22,6,7
186,138,324,2019-06-22,6,8
293,275,568,2019-06-22,6,9
521,389,910,2019-06-22,6,10
572,414,986,2019-06-22,6,11
564,439,1003,2019-06-22,6,12
572,412,984,2019-06-22,6,13
512,472,984,2019-06-22,6,14
507,493,1000,2019-06-22,6,15
389,455,844,2019-06-22,6,16
360,472,832,2019-06-22,6,17
396,501,897,2019-06-22,6,18
420,418,838,2019-06-22,6,19
305,330,635,2019-06-22,6,20
201,225,426,2019-06-22,6,21
152,208,360,2019-06-22,6,22
130,196,326,2019-06-22,6,23
95,183,278,2019-06-22,6,24
91,127,218,2019-06-23,7,1
72,86,158,2019-06-23,7,2
38,35,73,2019-06-23,7,3
34,27,61,2019-06-23,7,4
29,42,71,2019-06-23,7,5
61,52,113,2019-06-23,7,6
51,58,109,2019-06-23,7,7
64,66,130,2019-06-23,7,8
176,159,335,2019-06-23,7,9
340,245,585,2019-06-23,7,10
414,328,742,2019-06-23,7,11
556,430,986,2019-06-23,7,12
556,382,938,2019-06-23,7,13
556,444,1000,2019-06-23,7,14
492,503,995,2019-06-23,7,15
446,551,997,2019-06-23,7,16
401,599,1000,2019-06-23,7,17
398,541,939,2019-06-23,7,18
332,424,756,2019-06-23,7,19
250,308,558,2019-06-23,7,20
161,244,405,2019-06-23,7,21
153,172,325,2019-06-23,7,22
55,126,181,2019-06-23,7,23
36,72,108,2019-06-23,7,24
15,41,56,2019-06-24,1,1
7,12,19,2019-06-24,1,2
12,20,32,2019-06-24,1,3
14,19,33,2019-06-24,1,4
49,34,83,2019-06-24,1,5
217,177,394,2019-06-24,1,6
555,409,964,2019-06-24,1,7
821,527,1348,2019-06-24,1,8
654,537,1191,2019-06-24,1,9
585,527,1112,2019-06-24,1,10
644,612,1256,2019-06-24,1,11
647,594,1241,2019-06-24,1,12
590,613,1203,2019-06-24,1,13
590,603,1193,2019-06-24,1,14
569,581,1150,2019-06-24,1,15
710,716,1426,2019-06-24,1,16
790,811,1601,2019-06-24,1,17
586,677,1263,2019-06-24,1,18
432,606,1038,2019-06-24,1,19
287,362,649,2019-06-24,1,20
230,261,491,2019-06-24,1,21
44,63,107,2019-06-24,1,22
42,65,107,2019-06-24,1,23
33,44,77,2019-06-24,1,24
15,26,41,2019-06-25,2,1
11,16,27,2019-06-25,2,2
9,14,23,2019-06-25,2,3
11,14,25,2019-06-25,2,4
51,36,87,2019-06-25,2,5
240,153,393,2019-06-25,2,6
595,408,1003,2019-06-25,2,7
878,572,1450,2019-06-25,2,8
637,527,1164,2019-06-25,2,9
692,508,1200,2019-06-25,2,10
606,492,1098,2019-06-25,2,11
590,554,1144,2019-06-25,2,12
666,596,1262,2019-06-25,2,13
686,622,1308,2019-06-25,2,14
676,624,1300,2019-06-25,2,15
720,693,1413,2019-06-25,2,16
754,829,1583,2019-06-25,2,17
664,706,1370,2019-06-25,2,18
464,626,1090,2019-06-25,2,19
320,398,718,2019-06-25,2,20
205,278,483,2019-06-25,2,21
139,226,365,2019-06-25,2,22
101,147,248,2019-06-25,2,23
53,84,137,2019-06-25,2,24
21,28,49,2019-06-26,3,1
10,24,34,2019-06-26,3,2
6,8,14,2019-06-26,3,3
17,13,30,2019-06-26,3,4
53,44,97,2019-06-26,3,5
228,149,377,2019-06-26,3,6
571,392,963,2019-06-26,3,7
880,571,1451,2019-06-26,3,8
683,483,1166,2019-06-26,3,9
671,501,1172,2019-06-26,3,10
604,540,1144,2019-06-26,3,11
679,636,1315,2019-06-26,3,12
590,601,1191,2019-06-26,3,13
630,615,1245,2019-06-26,3,14
613,650,1263,2019-06-26,3,15
680,718,1398,2019-06-26,3,16
752,796,1548,2019-06-26,3,17
599,729,1328,2019-06-26,3,18
473,647,1120,2019-06-26,3,19
354,424,778,2019-06-26,3,20
211,316,527,2019-06-26,3,21
173,246,419,2019-06-26,3,22
85,145,230,2019-06-26,3,23
31,74,105,2019-06-26,3,24
29,38,67,2019-06-27,4,1
14,28,42,2019-06-27,4,2
17,16,33,2019-06-27,4,3
15,14,29,2019-06-27,4,4
48,51,99,2019-06-27,4,5
222,166,388,2019-06-27,4,6
563,385,948,2019-06-27,4,7
881,537,1418,2019-06-27,4,8
715,519,1234,2019-06-27,4,9
601,560,1161,2019-06-27,4,10
619,603,1222,2019-06-27,4,11
616,645,1261,2019-06-27,4,12
609,663,1272,2019-06-27,4,13
610,642,1252,2019-06-27,4,14
644,603,1247,2019-06-27,4,15
729,741,1470,2019-06-27,4,16
845,665,1510,2019-06-27,4,17
670,698,1368,2019-06-27,4,18
489,607,1096,2019-06-27,4,19
340,411,751,2019-06-27,4,20
240,276,516,2019-06-27,4,21
161,228,389,2019-06-27,4,22
108,196,304,2019-06-27,4,23
86,103,189,2019-06-27,4,24
24,46,70,2019-06-28,5,1
17,26,43,2019-06-28,5,2
19,24,43,2019-06-28,5,3
27,35,62,2019-06-28,5,4
63,49,112,2019-06-28,5,5
210,153,363,2019-06-28,5,6
512,355,867,2019-06-28,5,7
856,511,1367,2019-06-28,5,8
574,465,1039,2019-06-28,5,9
557,477,1034,2019-06-28,5,10
601,536,1137,2019-06-28,5,11
657,610,1267,2019-06-28,5,12
756,803,1559,2019-06-28,5,13
687,659,1346,2019-06-28,5,14
711,697,1408,2019-06-28,5,15
710,602,1312,2019-06-28,5,16
661,651,1312,2019-06-28,5,17
594,553,1147,2019-06-28,5,18
445,518,963,2019-06-28,5,19
308,410,718,2019-06-28,5,20
270,257,527,2019-06-28,5,21
139,226,365,2019-06-28,5,22
117,148,265,2019-06-28,5,23
73,113,186,2019-06-28,5,24
51,125,176,2019-06-29,6,1
49,60,109,2019-06-29,6,2
19,30,49,2019-06-29,6,3
21,25,46,2019-06-29,6,4
30,23,53,2019-06-29,6,5
82,54,136,2019-06-29,6,6
85,95,180,2019-06-29,6,7
209,141,350,2019-06-29,6,8
331,250,581,2019-06-29,6,9
566,383,949,2019-06-29,6,10
650,590,1240,2019-06-29,6,11
665,617,1282,2019-06-29,6,12
621,615,1236,2019-06-29,6,13
601,649,1250,2019-06-29,6,14
575,603,1178,2019-06-29,6,15
502,556,1058,2019-06-29,6,16
466,558,1024,2019-06-29,6,17
441,499,940,2019-06-29,6,18
349,452,801,2019-06-29,6,19
275,355,630,2019-06-29,6,20
220,272,492,2019-06-29,6,21
156,205,361,2019-06-29,6,22
108,188,296,2019-06-29,6,23
84,144,228,2019-06-29,6,24
74,127,201,2019-06-30,7,1
58,80,138,2019-06-30,7,2
42,47,89,2019-06-30,7,3
27,30,57,2019-06-30,7,4
25,29,54,2019-06-30,7,5
68,67,135,2019-06-30,7,6
75,70,145,2019-06-30,7,7
69,76,145,2019-06-30,7,8
173,151,324,2019-06-30,7,9
342,261,603,2019-06-30,7,10
561,335,896,2019-06-30,7,11
676,399,1075,2019-06-30,7,12
630,427,1057,2019-06-30,7,13
591,457,1048,2019-06-30,7,14
496,496,992,2019-06-30,7,15
391,547,938,2019-06-30,7,16
423,609,1032,2019-06-30,7,17
423,604,1027,2019-06-30,7,18
361,564,925,2019-06-30,7,19
294,415,709,2019-06-30,7,20
217,290,507,2019-06-30,7,21
141,158,299,2019-06-30,7,22
67,101,168,2019-06-30,7,23
23,54,77,2019-06-30,7,24
25,100,125,2019-07-01,1,1
19,58,77,2019-07-01,1,2
13,14,27,2019-07-01,1,3
13,9,22,2019-07-01,1,4
49,49,98,2019-07-01,1,5
221,179,400,2019-07-01,1,6
570,400,970,2019-07-01,1,7
671,450,1121,2019-07-01,1,8
624,458,1082,2019-07-01,1,9
636,523,1159,2019-07-01,1,10
628,620,1248,2019-07-01,1,11
600,583,1183,2019-07-01,1,12
557,563,1120,2019-07-01,1,13
554,616,1170,2019-07-01,1,14
570,604,1174,2019-07-01,1,15
663,686,1349,2019-07-01,1,16
833,768,1601,2019-07-01,1,17
575,696,1271,2019-07-01,1,18
431,520,951,2019-07-01,1,19
293,334,627,2019-07-01,1,20
194,226,420,2019-07-01,1,21
108,143,251,2019-07-01,1,22
88,79,167,2019-07-01,1,23
31,52,83,2019-07-01,1,24
11,24,35,2019-07-02,2,1
9,9,18,2019-07-02,2,2
8,14,22,2019-07-02,2,3
14,13,27,2019-07-02,2,4
47,37,84,2019-07-02,2,5
220,150,370,2019-07-02,2,6
524,365,889,2019-07-02,2,7
655,455,1110,2019-07-02,2,8
578,458,1036,2019-07-02,2,9
616,506,1122,2019-07-02,2,10
647,552,1199,2019-07-02,2,11
648,537,1185,2019-07-02,2,12
548,611,1159,2019-07-02,2,13
546,623,1169,2019-07-02,2,14
643,613,1256,2019-07-02,2,15
692,658,1350,2019-07-02,2,16
785,790,1575,2019-07-02,2,17
638,733,1371,2019-07-02,2,18
486,600,1086,2019-07-02,2,19
339,397,736,2019-07-02,2,20
197,251,448,2019-07-02,2,21
161,153,314,2019-07-02,2,22
82,112,194,2019-07-02,2,23
45,62,107,2019-07-02,2,24
33,28,61,2019-07-03,3,1
19,16,35,2019-07-03,3,2
6,10,16,2019-07-03,3,3
14,14,28,2019-07-03,3,4
58,49,107,2019-07-03,3,5
219,161,380,2019-07-03,3,6
577,366,943,2019-07-03,3,7
713,429,1142,2019-07-03,3,8
568,411,979,2019-07-03,3,9
630,462,1092,2019-07-03,3,10
645,591,1236,2019-07-03,3,11
608,623,1231,2019-07-03,3,12
616,599,1215,2019-07-03,3,13
600,646,1246,2019-07-03,3,14
606,636,1242,2019-07-03,3,15
653,721,1374,2019-07-03,3,16
800,815,1615,2019-07-03,3,17
622,690,1312,2019-07-03,3,18
428,553,981,2019-07-03,3,19
366,386,752,2019-07-03,3,20
217,259,476,2019-07-03,3,21
118,188,306,2019-07-03,3,22
98,103,201,2019-07-03,3,23
35,43,78,2019-07-03,3,24
23,23,46,2019-07-04,4,1
19,10,29,2019-07-04,4,2
12,18,30,2019-07-04,4,3
19,19,38,2019-07-04,4,4
50,41,91,2019-07-04,4,5
224,155,379,2019-07-04,4,6
565,362,927,2019-07-04,4,7
759,416,1175,2019-07-04,4,8
589,454,1043,2019-07-04,4,9
607,524,1131,2019-07-04,4,10
609,567,1176,2019-07-04,4,11
592,579,1171,2019-07-04,4,12
572,566,1138,2019-07-04,4,13
608,635,1243,2019-07-04,4,14
669,631,1300,2019-07-04,4,15
657,679,1336,2019-07-04,4,16
829,784,1613,2019-07-04,4,17
631,690,1321,2019-07-04,4,18
472,566,1038,2019-07-04,4,19
285,358,643,2019-07-04,4,20
219,265,484,2019-07-04,4,21
145,213,358,2019-07-04,4,22
73,108,181,2019-07-04,4,23
32,57,89,2019-07-04,4,24
19,23,42,2019-07-05,5,1
14,14,28,2019-07-05,5,2
10,8,18,2019-07-05,5,3
14,16,30,2019-07-05,5,4
49,41,90,2019-07-05,5,5
217,155,372,2019-07-05,5,6
525,333,858,2019-07-05,5,7
659,419,1078,2019-07-05,5,8
631,432,1063,2019-07-05,5,9
606,488,1094,2019-07-05,5,10
634,532,1166,2019-07-05,5,11
693,650,1343,2019-07-05,5,12
682,627,1309,2019-07-05,5,13
682,718,1400,2019-07-05,5,14
676,631,1307,2019-07-05,5,15
663,600,1263,2019-07-05,5,16
662,592,1254,2019-07-05,5,17
564,506,1070,2019-07-05,5,18
463,478,941,2019-07-05,5,19
292,325,617,2019-07-05,5,20
234,209,443,2019-07-05,5,21
115,167,282,2019-07-05,5,22
100,135,235,2019-07-05,5,23
68,90,158,2019-07-05,5,24
32,41,73,2019-07-06,6,1
28,21,49,2019-07-06,6,2
27,23,50,2019-07-06,6,3
18,18,36,2019-07-06,6,4
24,31,55,2019-07-06,6,5
64,50,114,2019-07-06,6,6
89,82,171,2019-07-06,6,7
144,125,269,2019-07-06,6,8
284,234,518,2019-07-06,6,9
443,384,827,2019-07-06,6,10
513,493,1006,2019-07-06,6,11
585,551,1136,2019-07-06,6,12
524,552,1076,2019-07-06,6,13
520,581,1101,2019-07-06,6,14
569,481,1050,2019-07-06,6,15
496,460,956,2019-07-06,6,16
450,469,919,2019-07-06,6,17
492,414,906,2019-07-06,6,18
380,377,757,2019-07-06,6,19
267,258,525,2019-07-06,6,20
169,202,371,2019-07-06,6,21
145,157,302,2019-07-06,6,22
123,257,380,2019-07-06,6,23
87,257,344,2019-07-06,6,24
62,79,141,2019-07-07,7,1
56,54,110,2019-07-07,7,2
31,44,75,2019-07-07,7,3
22,28,50,2019-07-07,7,4
30,35,65,2019-07-07,7,5
66,55,121,2019-07-07,7,6
54,51,105,2019-07-07,7,7
82,75,157,2019-07-07,7,8
165,108,273,2019-07-07,7,9
336,246,582,2019-07-07,7,10
489,388,877,2019-07-07,7,11
578,506,1084,2019-07-07,7,12
624,565,1189,2019-07-07,7,13
588,576,1164,2019-07-07,7,14
614,588,1202,2019-07-07,7,15
521,584,1105,2019-07-07,7,16
466,644,1110,2019-07-07,7,17
412,545,957,2019-07-07,7,18
314,340,654,2019-07-07,7,19
225,280,505,2019-07-07,7,20
170,189,359,2019-07-07,7,21
109,131,240,2019-07-07,7,22
69,89,158,2019-07-07,7,23
31,48,79,2019-07-07,7,24
12,23,35,2019-07-08,1,1
8,12,20,2019-07-08,1,2
8,12,20,2019-07-08,1,3
14,13,27,2019-07-08,1,4
40,48,88,2019-07-08,1,5
219,163,382,2019-07-08,1,6
514,363,877,2019-07-08,1,7
626,426,1052,2019-07-08,1,8
558,380,938,2019-07-08,1,9
576,450,1026,2019-07-08,1,10
626,608,1234,2019-07-08,1,11
579,599,1178,2019-07-08,1,12
545,562,1107,2019-07-08,1,13
518,576,1094,2019-07-08,1,14
586,612,1198,2019-07-08,1,15
683,699,1382,2019-07-08,1,16
732,781,1513,2019-07-08,1,17
599,698,1297,2019-07-08,1,18
444,518,962,2019-07-08,1,19
301,324,625,2019-07-08,1,20
192,215,407,2019-07-08,1,21
108,140,248,2019-07-08,1,22
80,108,188,2019-07-08,1,23
35,49,84,2019-07-08,1,24
20,28,48,2019-07-09,2,1
11,10,21,2019-07-09,2,2
13,12,25,2019-07-09,2,3
10,14,24,2019-07-09,2,4
44,42,86,2019-07-09,2,5
187,145,332,2019-07-09,2,6
512,361,873,2019-07-09,2,7
592,427,1019,2019-07-09,2,8
504,463,967,2019-07-09,2,9
596,499,1095,2019-07-09,2,10
624,600,1224,2019-07-09,2,11
595,574,1169,2019-07-09,2,12
578,595,1173,2019-07-09,2,13
563,561,1124,2019-07-09,2,14
685,622,1307,2019-07-09,2,15
673,702,1375,2019-07-09,2,16
753,759,1512,2019-07-09,2,17
604,699,1303,2019-07-09,2,18
391,512,903,2019-07-09,2,19
304,346,650,2019-07-09,2,20
206,241,447,2019-07-09,2,21
154,148,302,2019-07-09,2,22
88,95,183,2019-07-09,2,23
55,54,109,2019-07-09,2,24
20,23,43,2019-07-10,3,1
8,14,22,2019-07-10,3,2
7,9,16,2019-07-10,3,3
9,8,17,2019-07-10,3,4
50,38,88,2019-07-10,3,5
179,152,331,2019-07-10,3,6
466,349,815,2019-07-10,3,7
603,437,1040,2019-07-10,3,8
530,397,927,2019-07-10,3,9
620,463,1083,2019-07-10,3,10
585,584,1169,2019-07-10,3,11
598,583,1181,2019-07-10,3,12
559,552,1111,2019-07-10,3,13
579,661,1240,2019-07-10,3,14
578,574,1152,2019-07-10,3,15
628,659,1287,2019-07-10,3,16
775,792,1567,2019-07-10,3,17
568,643,1211,2019-07-10,3,18
439,531,970,2019-07-10,3,19
337,393,730,2019-07-10,3,20
200,244,444,2019-07-10,3,21
179,211,390,2019-07-10,3,22
101,166,267,2019-07-10,3,23
45,50,95,2019-07-10,3,24
18,25,43,2019-07-11,4,1
15,13,28,2019-07-11,4,2
8,16,24,2019-07-11,4,3
11,14,25,2019-07-11,4,4
42,45,87,2019-07-11,4,5
186,142,328,2019-07-11,4,6
476,357,833,2019-07-11,4,7
618,407,1025,2019-07-11,4,8
552,435,987,2019-07-11,4,9
556,530,1086,2019-07-11,4,10
588,602,1190,2019-07-11,4,11
572,652,1224,2019-07-11,4,12
563,600,1163,2019-07-11,4,13
575,636,1211,2019-07-11,4,14
603,590,1193,2019-07-11,4,15
656,677,1333,2019-07-11,4,16
765,704,1469,2019-07-11,4,17
556,598,1154,2019-07-11,4,18
422,522,944,2019-07-11,4,19
287,372,659,2019-07-11,4,20
192,230,422,2019-07-11,4,21
138,171,309,2019-07-11,4,22
92,105,197,2019-07-11,4,23
39,44,83,2019-07-11,4,24
24,20,44,2019-07-12,5,1
12,13,25,2019-07-12,5,2
9,8,17,2019-07-12,5,3
10,12,22,2019-07-12,5,4
36,32,68,2019-07-12,5,5
174,140,314,2019-07-12,5,6
458,323,781,2019-07-12,5,7
576,394,970,2019-07-12,5,8
496,383,879,2019-07-12,5,9
525,451,976,2019-07-12,5,10
552,516,1068,2019-07-12,5,11
650,670,1320,2019-07-12,5,12
698,601,1299,2019-07-12,5,13
574,599,1173,2019-07-12,5,14
622,545,1167,2019-07-12,5,15
575,525,1100,2019-07-12,5,16
607,549,1156,2019-07-12,5,17
501,477,978,2019-07-12,5,18
391,439,830,2019-07-12,5,19
277,304,581,2019-07-12,5,20
189,237,426,2019-07-12,5,21
131,177,308,2019-07-12,5,22
122,126,248,2019-07-12,5,23
59,91,150,2019-07-12,5,24
43,49,92,2019-07-13,6,1
18,31,49,2019-07-13,6,2
22,19,41,2019-07-13,6,3
11,14,25,2019-07-13,6,4
28,23,51,2019-07-13,6,5
80,47,127,2019-07-13,6,6
83,82,165,2019-07-13,6,7
158,103,261,2019-07-13,6,8
281,235,516,2019-07-13,6,9
502,392,894,2019-07-13,6,10
615,588,1203,2019-07-13,6,11
605,556,1161,2019-07-13,6,12
575,532,1107,2019-07-13,6,13
492,438,930,2019-07-13,6,14
526,557,1083,2019-07-13,6,15
438,491,929,2019-07-13,6,16
432,484,916,2019-07-13,6,17
439,438,877,2019-07-13,6,18
301,361,662,2019-07-13,6,19
250,301,551,2019-07-13,6,20
173,213,386,2019-07-13,6,21
133,163,296,2019-07-13,6,22
87,109,196,2019-07-13,6,23
74,96,170,2019-07-13,6,24
48,70,118,2019-07-14,7,1
45,42,87,2019-07-14,7,2
15,25,40,2019-07-14,7,3
20,23,43,2019-07-14,7,4
32,25,57,2019-07-14,7,5
55,51,106,2019-07-14,7,6
42,49,91,2019-07-14,7,7
46,66,112,2019-07-14,7,8
128,104,232,2019-07-14,7,9
256,205,461,2019-07-14,7,10
389,320,709,2019-07-14,7,11
469,467,936,2019-07-14,7,12
489,392,881,2019-07-14,7,13
460,472,932,2019-07-14,7,14
540,450,990,2019-07-14,7,15
481,534,1015,2019-07-14,7,16
395,522,917,2019-07-14,7,17
370,474,844,2019-07-14,7,18
293,384,677,2019-07-14,7,19
248,256,504,2019-07-14,7,20
173,176,349,2019-07-14,7,21
91,126,217,2019-07-14,7,22
56,101,157,2019-07-14,7,23
22,48,70,2019-07-14,7,24
16,22,38,2019-07-15,1,1
7,11,18,2019-07-15,1,2
11,11,22,2019-07-15,1,3
9,11,20,2019-07-15,1,4
38,38,76,2019-07-15,1,5
197,150,347,2019-07-15,1,6
448,345,793,2019-07-15,1,7
554,377,931,2019-07-15,1,8
444,387,831,2019-07-15,1,9
570,474,1044,2019-07-15,1,10
585,609,1194,2019-07-15,1,11
592,658,1250,2019-07-15,1,12
595,618,1213,2019-07-15,1,13
553,565,1118,2019-07-15,1,14
560,570,1130,2019-07-15,1,15
588,669,1257,2019-07-15,1,16
715,714,1429,2019-07-15,1,17
548,613,1161,2019-07-15,1,18
459,502,961,2019-07-15,1,19
323,314,637,2019-07-15,1,20
194,236,430,2019-07-15,1,21
122,132,254,2019-07-15,1,22
83,75,158,2019-07-15,1,23
30,34,64,2019-07-15,1,24
5,15,20,2019-07-16,2,1
11,12,23,2019-07-16,2,2
12,17,29,2019-07-16,2,3
4,17,21,2019-07-16,2,4
47,33,80,2019-07-16,2,5
163,139,302,2019-07-16,2,6
456,336,792,2019-07-16,2,7
581,367,948,2019-07-16,2,8
453,369,822,2019-07-16,2,9
539,510,1049,2019-07-16,2,10
583,627,1210,2019-07-16,2,11
622,575,1197,2019-07-16,2,12
541,563,1104,2019-07-16,2,13
560,572,1132,2019-07-16,2,14
597,544,1141,2019-07-16,2,15
617,617,1234,2019-07-16,2,16
759,687,1446,2019-07-16,2,17
569,623,1192,2019-07-16,2,18
423,582,1005,2019-07-16,2,19
309,316,625,2019-07-16,2,20
223,268,491,2019-07-16,2,21
141,211,352,2019-07-16,2,22
95,115,210,2019-07-16,2,23
37,65,102,2019-07-16,2,24
16,30,46,2019-07-17,3,1
9,7,16,2019-07-17,3,2
10,10,20,2019-07-17,3,3
7,12,19,2019-07-17,3,4
45,38,83,2019-07-17,3,5
185,130,315,2019-07-17,3,6
426,313,739,2019-07-17,3,7
561,387,948,2019-07-17,3,8
455,355,810,2019-07-17,3,9
554,462,1016,2019-07-17,3,10
616,601,1217,2019-07-17,3,11
592,610,1202,2019-07-17,3,12
579,572,1151,2019-07-17,3,13
545,559,1104,2019-07-17,3,14
577,631,1208,2019-07-17,3,15
603,670,1273,2019-07-17,3,16
742,727,1469,2019-07-17,3,17
561,616,1177,2019-07-17,3,18
409,479,888,2019-07-17,3,19
325,358,683,2019-07-17,3,20
230,267,497,2019-07-17,3,21
168,182,350,2019-07-17,3,22
85,131,216,2019-07-17,3,23
36,60,96,2019-07-17,3,24
17,32,49,2019-07-18,4,1
22,16,38,2019-07-18,4,2
14,17,31,2019-07-18,4,3
20,17,37,2019-07-18,4,4
44,36,80,2019-07-18,4,5
174,138,312,2019-07-18,4,6
433,314,747,2019-07-18,4,7
564,393,957,2019-07-18,4,8
460,379,839,2019-07-18,4,9
587,514,1101,2019-07-18,4,10
679,508,1187,2019-07-18,4,11
567,547,1114,2019-07-18,4,12
528,542,1070,2019-07-18,4,13
539,543,1082,2019-07-18,4,14
602,536,1138,2019-07-18,4,15
620,609,1229,2019-07-18,4,16
734,687,1421,2019-07-18,4,17
539,632,1171,2019-07-18,4,18
413,534,947,2019-07-18,4,19
288,321,609,2019-07-18,4,20
223,251,474,2019-07-18,4,21
126,185,311,2019-07-18,4,22
102,156,258,2019-07-18,4,23
50,61,111,2019-07-18,4,24
21,30,51,2019-07-19,5,1
4,17,21,2019-07-19,5,2
7,19,26,2019-07-19,5,3
8,18,26,2019-07-19,5,4
46,38,84,2019-07-19,5,5
177,143,320,2019-07-19,5,6
383,273,656,2019-07-19,5,7
512,353,865,2019-07-19,5,8
463,390,853,2019-07-19,5,9
514,517,1031,2019-07-19,5,10
591,567,1158,2019-07-19,5,11
619,650,1269,2019-07-19,5,12
667,767,1434,2019-07-19,5,13
655,599,1254,2019-07-19,5,14
676,643,1319,2019-07-19,5,15
629,645,1274,2019-07-19,5,16
610,662,1272,2019-07-19,5,17
550,603,1153,2019-07-19,5,18
472,569,1041,2019-07-19,5,19
330,407,737,2019-07-19,5,20
205,270,475,2019-07-19,5,21
144,207,351,2019-07-19,5,22
121,158,279,2019-07-19,5,23
78,78,156,2019-07-19,5,24
45,52,97,2019-07-20,6,1
31,34,65,2019-07-20,6,2
19,17,36,2019-07-20,6,3
17,19,36,2019-07-20,6,4
24,22,46,2019-07-20,6,5
74,56,130,2019-07-20,6,6
71,75,146,2019-07-20,6,7
171,131,302,2019-07-20,6,8
287,210,497,2019-07-20,6,9
430,389,819,2019-07-20,6,10
584,577,1161,2019-07-20,6,11
582,627,1209,2019-07-20,6,12
578,624,1202,2019-07-20,6,13
504,560,1064,2019-07-20,6,14
488,505,993,2019-07-20,6,15
434,483,917,2019-07-20,6,16
408,501,909,2019-07-20,6,17
380,529,909,2019-07-20,6,18
319,353,672,2019-07-20,6,19
231,294,525,2019-07-20,6,20
157,194,351,2019-07-20,6,21
115,169,284,2019-07-20,6,22
142,137,279,2019-07-20,6,23
83,85,168,2019-07-20,6,24
58,61,119,2019-07-21,7,1
42,34,76,2019-07-21,7,2
36,37,73,2019-07-21,7,3
30,20,50,2019-07-21,7,4
26,20,46,2019-07-21,7,5
54,48,102,2019-07-21,7,6
33,55,88,2019-07-21,7,7
64,56,120,2019-07-21,7,8
128,109,237,2019-07-21,7,9
259,211,470,2019-07-21,7,10
391,336,727,2019-07-21,7,11
465,422,887,2019-07-21,7,12
465,445,910,2019-07-21,7,13
493,486,979,2019-07-21,7,14
494,487,981,2019-07-21,7,15
433,534,967,2019-07-21,7,16
411,486,897,2019-07-21,7,17
412,461,873,2019-07-21,7,18
343,373,716,2019-07-21,7,19
237,261,498,2019-07-21,7,20
156,200,356,2019-07-21,7,21
106,128,234,2019-07-21,7,22
73,93,166,2019-07-21,7,23
18,35,53,2019-07-21,7,24
7,24,31,2019-07-22,1,1
9,12,21,2019-07-22,1,2
7,11,18,2019-07-22,1,3
13,13,26,2019-07-22,1,4
53,36,89,2019-07-22,1,5
186,150,336,2019-07-22,1,6
420,324,744,2019-07-22,1,7
532,387,919,2019-07-22,1,8
454,402,856,2019-07-22,1,9
561,485,1046,2019-07-22,1,10
605,571,1176,2019-07-22,1,11
576,622,1198,2019-07-22,1,12
567,591,1158,2019-07-22,1,13
598,560,1158,2019-07-22,1,14
552,573,1125,2019-07-22,1,15
577,616,1193,2019-07-22,1,16
709,723,1432,2019-07-22,1,17
540,584,1124,2019-07-22,1,18
392,481,873,2019-07-22,1,19
235,274,509,2019-07-22,1,20
171,197,368,2019-07-22,1,21
110,119,229,2019-07-22,1,22
69,84,153,2019-07-22,1,23
29,44,73,2019-07-22,1,24
18,22,40,2019-07-23,2,1
12,10,22,2019-07-23,2,2
10,8,18,2019-07-23,2,3
9,22,31,2019-07-23,2,4
52,32,84,2019-07-23,2,5
173,127,300,2019-07-23,2,6
433,294,727,2019-07-23,2,7
526,395,921,2019-07-23,2,8
469,401,870,2019-07-23,2,9
563,501,1064,2019-07-23,2,10
660,595,1255,2019-07-23,2,11
613,558,1171,2019-07-23,2,12
569,505,1074,2019-07-23,2,13
614,532,1146,2019-07-23,2,14
542,586,1128,2019-07-23,2,15
579,629,1208,2019-07-23,2,16
645,655,1300,2019-07-23,2,17
504,726,1230,2019-07-23,2,18
411,573,984,2019-07-23,2,19
327,355,682,2019-07-23,2,20
203,258,461,2019-07-23,2,21
117,214,331,2019-07-23,2,22
88,124,212,2019-07-23,2,23
39,48,87,2019-07-23,2,24
17,39,56,2019-07-24,3,1
11,10,21,2019-07-24,3,2
8,10,18,2019-07-24,3,3
13,26,39,2019-07-24,3,4
61,39,100,2019-07-24,3,5
179,124,303,2019-07-24,3,6
422,304,726,2019-07-24,3,7
537,376,913,2019-07-24,3,8
501,413,914,2019-07-24,3,9
601,479,1080,2019-07-24,3,10
713,566,1279,2019-07-24,3,11
612,543,1155,2019-07-24,3,12
640,563,1203,2019-07-24,3,13
576,594,1170,2019-07-24,3,14
552,574,1126,2019-07-24,3,15
602,676,1278,2019-07-24,3,16
634,719,1353,2019-07-24,3,17
544,654,1198,2019-07-24,3,18
431,592,1023,2019-07-24,3,19
335,360,695,2019-07-24,3,20
199,242,441,2019-07-24,3,21
152,160,312,2019-07-24,3,22
86,100,186,2019-07-24,3,23
42,61,103,2019-07-24,3,24
26,31,57,2019-07-25,4,1
14,15,29,2019-07-25,4,2
13,15,28,2019-07-25,4,3
14,22,36,2019-07-25,4,4
49,27,76,2019-07-25,4,5
174,142,316,2019-07-25,4,6
400,299,699,2019-07-25,4,7
532,361,893,2019-07-25,4,8
486,405,891,2019-07-25,4,9
558,487,1045,2019-07-25,4,10
645,515,1160,2019-07-25,4,11
604,538,1142,2019-07-25,4,12
590,544,1134,2019-07-25,4,13
597,556,1153,2019-07-25,4,14
576,574,1150,2019-07-25,4,15
668,650,1318,2019-07-25,4,16
620,725,1345,2019-07-25,4,17
591,721,1312,2019-07-25,4,18
464,606,1070,2019-07-25,4,19
343,487,830,2019-07-25,4,20
244,347,591,2019-07-25,4,21
176,287,463,2019-07-25,4,22
95,237,332,2019-07-25,4,23
51,119,170,2019-07-25,4,24
25,43,68,2019-07-26,5,1
7,13,20,2019-07-26,5,2
14,9,23,2019-07-26,5,3
6,22,28,2019-07-26,5,4
53,39,92,2019-07-26,5,5
180,149,329,2019-07-26,5,6
374,295,669,2019-07-26,5,7
490,340,830,2019-07-26,5,8
471,377,848,2019-07-26,5,9
556,510,1066,2019-07-26,5,10
657,650,1307,2019-07-26,5,11
668,676,1344,2019-07-26,5,12
682,651,1333,2019-07-26,5,13
614,764,1378,2019-07-26,5,14
598,643,1241,2019-07-26,5,15
567,607,1174,2019-07-26,5,16
565,605,1170,2019-07-26,5,17
510,582,1092,2019-07-26,5,18
423,551,974,2019-07-26,5,19
266,385,651,2019-07-26,5,20
224,267,491,2019-07-26,5,21
150,184,334,2019-07-26,5,22
102,127,229,2019-07-26,5,23
70,91,161,2019-07-26,5,24
44,61,105,2019-07-27,6,1
31,25,56,2019-07-27,6,2
18,24,42,2019-07-27,6,3
18,15,33,2019-07-27,6,4
20,21,41,2019-07-27,6,5
66,46,112,2019-07-27,6,6
65,86,151,2019-07-27,6,7
157,137,294,2019-07-27,6,8
294,260,554,2019-07-27,6,9
475,388,863,2019-07-27,6,10
607,506,1113,2019-07-27,6,11
620,597,1217,2019-07-27,6,12
653,529,1182,2019-07-27,6,13
583,578,1161,2019-07-27,6,14
578,516,1094,2019-07-27,6,15
461,468,929,2019-07-27,6,16
411,480,891,2019-07-27,6,17
433,512,945,2019-07-27,6,18
362,419,781,2019-07-27,6,19
280,316,596,2019-07-27,6,20
184,266,450,2019-07-27,6,21
127,161,288,2019-07-27,6,22
98,120,218,2019-07-27,6,23
72,104,176,2019-07-27,6,24
71,58,129,2019-07-28,7,1
39,50,89,2019-07-28,7,2
27,39,66,2019-07-28,7,3
23,31,54,2019-07-28,7,4
27,32,59,2019-07-28,7,5
56,49,105,2019-07-28,7,6
43,44,87,2019-07-28,7,7
67,64,131,2019-07-28,7,8
119,117,236,2019-07-28,7,9
235,235,470,2019-07-28,7,10
375,324,699,2019-07-28,7,11
430,414,844,2019-07-28,7,12
490,420,910,2019-07-28,7,13
444,470,914,2019-07-28,7,14
458,408,866,2019-07-28,7,15
441,428,869,2019-07-28,7,16
425,505,930,2019-07-28,7,17
386,540,926,2019-07-28,7,18
343,378,721,2019-07-28,7,19
285,305,590,2019-07-28,7,20
182,207,389,2019-07-28,7,21
129,186,315,2019-07-28,7,22
91,120,211,2019-07-28,7,23
35,53,88,2019-07-28,7,24
4,6,10,2019-07-29,1,1
7,16,23,2019-07-29,1,2
13,12,25,2019-07-29,1,3
11,17,28,2019-07-29,1,4
52,67,119,2019-07-29,1,5
197,145,342,2019-07-29,1,6
415,346,761,2019-07-29,1,7
540,388,928,2019-07-29,1,8
505,393,898,2019-07-29,1,9
540,547,1087,2019-07-29,1,10
601,580,1181,2019-07-29,1,11
561,530,1091,2019-07-29,1,12
589,532,1121,2019-07-29,1,13
543,509,1052,2019-07-29,1,14
565,530,1095,2019-07-29,1,15
602,655,1257,2019-07-29,1,16
666,740,1406,2019-07-29,1,17
522,599,1121,2019-07-29,1,18
370,548,918,2019-07-29,1,19
263,327,590,2019-07-29,1,20
177,242,419,2019-07-29,1,21
121,155,276,2019-07-29,1,22
88,83,171,2019-07-29,1,23
42,48,90,2019-07-29,1,24
18,19,37,2019-07-30,2,1
6,18,24,2019-07-30,2,2
11,12,23,2019-07-30,2,3
8,15,23,2019-07-30,2,4
48,32,80,2019-07-30,2,5
169,159,328,2019-07-30,2,6
443,325,768,2019-07-30,2,7
578,396,974,2019-07-30,2,8
520,371,891,2019-07-30,2,9
595,439,1034,2019-07-30,2,10
565,632,1197,2019-07-30,2,11
590,569,1159,2019-07-30,2,12
525,588,1113,2019-07-30,2,13
560,574,1134,2019-07-30,2,14
580,597,1177,2019-07-30,2,15
588,664,1252,2019-07-30,2,16
716,766,1482,2019-07-30,2,17
582,710,1292,2019-07-30,2,18
443,582,1025,2019-07-30,2,19
309,385,694,2019-07-30,2,20
196,228,424,2019-07-30,2,21
159,196,355,2019-07-30,2,22
86,130,216,2019-07-30,2,23
36,50,86,2019-07-30,2,24
25,27,52,2019-07-31,3,1
9,13,22,2019-07-31,3,2
12,10,22,2019-07-31,3,3
6,13,19,2019-07-31,3,4
47,36,83,2019-07-31,3,5
175,141,316,2019-07-31,3,6
425,307,732,2019-07-31,3,7
533,381,914,2019-07-31,3,8
490,381,871,2019-07-31,3,9
528,424,952,2019-07-31,3,10
573,567,1140,2019-07-31,3,11
572,628,1200,2019-07-31,3,12
557,652,1209,2019-07-31,3,13
546,599,1145,2019-07-31,3,14
559,633,1192,2019-07-31,3,15
531,698,1229,2019-07-31,3,16
694,705,1399,2019-07-31,3,17
570,600,1170,2019-07-31,3,18
515,484,999,2019-07-31,3,19
288,345,633,2019-07-31,3,20
190,243,433,2019-07-31,3,21
131,162,293,2019-07-31,3,22
81,141,222,2019-07-31,3,23
39,48,87,2019-07-31,3,24
17,26,43,2019-08-01,4,1
17,16,33,2019-08-01,4,2
12,10,22,2019-08-01,4,3
13,21,34,2019-08-01,4,4
47,34,81,2019-08-01,4,5
179,142,321,2019-08-01,4,6
417,325,742,2019-08-01,4,7
586,391,977,2019-08-01,4,8
461,414,875,2019-08-01,4,9
523,447,970,2019-08-01,4,10
617,537,1154,2019-08-01,4,11
570,586,1156,2019-08-01,4,12
544,569,1113,2019-08-01,4,13
484,527,1011,2019-08-01,4,14
584,607,1191,2019-08-01,4,15
620,644,1264,2019-08-01,4,16
747,778,1525,2019-08-01,4,17
544,628,1172,2019-08-01,4,18
419,484,903,2019-08-01,4,19
292,333,625,2019-08-01,4,20
201,246,447,2019-08-01,4,21
152,198,350,2019-08-01,4,22
100,121,221,2019-08-01,4,23
48,73,121,2019-08-01,4,24
23,42,65,2019-08-02,5,1
14,15,29,2019-08-02,5,2
12,14,26,2019-08-02,5,3
12,12,24,2019-08-02,5,4
51,36,87,2019-08-02,5,5
158,132,290,2019-08-02,5,6
390,307,697,2019-08-02,5,7
518,350,868,2019-08-02,5,8
449,368,817,2019-08-02,5,9
578,461,1039,2019-08-02,5,10
601,581,1182,2019-08-02,5,11
603,638,1241,2019-08-02,5,12
593,633,1226,2019-08-02,5,13
591,650,1241,2019-08-02,5,14
607,633,1240,2019-08-02,5,15
635,585,1220,2019-08-02,5,16
630,543,1173,2019-08-02,5,17
511,466,977,2019-08-02,5,18
374,471,845,2019-08-02,5,19
290,346,636,2019-08-02,5,20
200,264,464,2019-08-02,5,21
155,197,352,2019-08-02,5,22
101,195,296,2019-08-02,5,23
57,125,182,2019-08-02,5,24
48,63,111,2019-08-03,6,1
31,39,70,2019-08-03,6,2
23,20,43,2019-08-03,6,3
16,20,36,2019-08-03,6,4
27,22,49,2019-08-03,6,5
65,64,129,2019-08-03,6,6
87,61,148,2019-08-03,6,7
146,127,273,2019-08-03,6,8
262,237,499,2019-08-03,6,9
518,385,903,2019-08-03,6,10
646,537,1183,2019-08-03,6,11
618,503,1121,2019-08-03,6,12
624,499,1123,2019-08-03,6,13
608,465,1073,2019-08-03,6,14
618,445,1063,2019-08-03,6,15
516,559,1075,2019-08-03,6,16
500,566,1066,2019-08-03,6,17
461,521,982,2019-08-03,6,18
361,439,800,2019-08-03,6,19
273,278,551,2019-08-03,6,20
240,248,488,2019-08-03,6,21
148,278,426,2019-08-03,6,22
126,349,475,2019-08-03,6,23
81,186,267,2019-08-03,6,24
59,81,140,2019-08-04,7,1
47,52,99,2019-08-04,7,2
27,33,60,2019-08-04,7,3
26,29,55,2019-08-04,7,4
30,26,56,2019-08-04,7,5
50,52,102,2019-08-04,7,6
45,44,89,2019-08-04,7,7
68,70,138,2019-08-04,7,8
176,153,329,2019-08-04,7,9
289,303,592,2019-08-04,7,10
473,369,842,2019-08-04,7,11
571,384,955,2019-08-04,7,12
610,517,1127,2019-08-04,7,13
544,518,1062,2019-08-04,7,14
565,520,1085,2019-08-04,7,15
426,529,955,2019-08-04,7,16
436,581,1017,2019-08-04,7,17
376,619,995,2019-08-04,7,18
306,460,766,2019-08-04,7,19
292,302,594,2019-08-04,7,20
195,236,431,2019-08-04,7,21
152,190,342,2019-08-04,7,22
109,98,207,2019-08-04,7,23
29,200,229,2019-08-04,7,24
22,65,87,2019-08-05,1,1
12,20,32,2019-08-05,1,2
12,8,20,2019-08-05,1,3
16,13,29,2019-08-05,1,4
61,43,104,2019-08-05,1,5
166,138,304,2019-08-05,1,6
474,377,851,2019-08-05,1,7
611,410,1021,2019-08-05,1,8
534,392,926,2019-08-05,1,9
535,493,1028,2019-08-05,1,10
590,541,1131,2019-08-05,1,11
576,583,1159,2019-08-05,1,12
520,598,1118,2019-08-05,1,13
584,561,1145,2019-08-05,1,14
589,597,1186,2019-08-05,1,15
584,683,1267,2019-08-05,1,16
719,765,1484,2019-08-05,1,17
587,720,1307,2019-08-05,1,18
402,564,966,2019-08-05,1,19
284,310,594,2019-08-05,1,20
188,210,398,2019-08-05,1,21
171,170,341,2019-08-05,1,22
86,90,176,2019-08-05,1,23
32,41,73,2019-08-05,1,24
18,24,42,2019-08-06,2,1
10,20,30,2019-08-06,2,2
12,14,26,2019-08-06,2,3
16,22,38,2019-08-06,2,4
43,33,76,2019-08-06,2,5
181,142,323,2019-08-06,2,6
433,350,783,2019-08-06,2,7
596,442,1038,2019-08-06,2,8
518,456,974,2019-08-06,2,9
541,505,1046,2019-08-06,2,10
596,552,1148,2019-08-06,2,11
608,570,1178,2019-08-06,2,12
553,533,1086,2019-08-06,2,13
542,548,1090,2019-08-06,2,14
614,604,1218,2019-08-06,2,15
620,601,1221,2019-08-06,2,16
753,665,1418,2019-08-06,2,17
553,671,1224,2019-08-06,2,18
412,539,951,2019-08-06,2,19
286,354,640,2019-08-06,2,20
213,249,462,2019-08-06,2,21
164,187,351,2019-08-06,2,22
98,126,224,2019-08-06,2,23
44,41,85,2019-08-06,2,24
23,35,58,2019-08-07,3,1
27,21,48,2019-08-07,3,2
10,14,24,2019-08-07,3,3
9,18,27,2019-08-07,3,4
49,35,84,2019-08-07,3,5
175,149,324,2019-08-07,3,6
446,327,773,2019-08-07,3,7
618,443,1061,2019-08-07,3,8
571,412,983,2019-08-07,3,9
608,459,1067,2019-08-07,3,10
619,595,1214,2019-08-07,3,11
612,599,1211,2019-08-07,3,12
528,608,1136,2019-08-07,3,13
526,593,1119,2019-08-07,3,14
605,652,1257,2019-08-07,3,15
611,689,1300,2019-08-07,3,16
733,773,1506,2019-08-07,3,17
618,639,1257,2019-08-07,3,18
486,526,1012,2019-08-07,3,19
326,356,682,2019-08-07,3,20
218,241,459,2019-08-07,3,21
153,217,370,2019-08-07,3,22
89,166,255,2019-08-07,3,23
34,48,82,2019-08-07,3,24
30,25,55,2019-08-08,4,1
9,13,22,2019-08-08,4,2
10,11,21,2019-08-08,4,3
12,14,26,2019-08-08,4,4
39,31,70,2019-08-08,4,5
188,147,335,2019-08-08,4,6
452,361,813,2019-08-08,4,7
597,425,1022,2019-08-08,4,8
576,457,1033,2019-08-08,4,9
545,471,1016,2019-08-08,4,10
599,536,1135,2019-08-08,4,11
567,620,1187,2019-08-08,4,12
566,593,1159,2019-08-08,4,13
549,666,1215,2019-08-08,4,14
624,588,1212,2019-08-08,4,15
661,683,1344,2019-08-08,4,16
795,752,1547,2019-08-08,4,17
640,651,1291,2019-08-08,4,18
491,585,1076,2019-08-08,4,19
344,367,711,2019-08-08,4,20
236,237,473,2019-08-08,4,21
187,184,371,2019-08-08,4,22
106,128,234,2019-08-08,4,23
30,56,86,2019-08-08,4,24
22,29,51,2019-08-09,5,1
7,16,23,2019-08-09,5,2
17,10,27,2019-08-09,5,3
13,18,31,2019-08-09,5,4
41,30,71,2019-08-09,5,5
185,156,341,2019-08-09,5,6
393,302,695,2019-08-09,5,7
589,395,984,2019-08-09,5,8
559,405,964,2019-08-09,5,9
618,499,1117,2019-08-09,5,10
683,602,1285,2019-08-09,5,11
654,651,1305,2019-08-09,5,12
646,633,1279,2019-08-09,5,13
629,618,1247,2019-08-09,5,14
677,637,1314,2019-08-09,5,15
614,663,1277,2019-08-09,5,16
613,632,1245,2019-08-09,5,17
590,558,1148,2019-08-09,5,18
473,507,980,2019-08-09,5,19
348,328,676,2019-08-09,5,20
216,239,455,2019-08-09,5,21
145,164,309,2019-08-09,5,22
115,185,300,2019-08-09,5,23
56,141,197,2019-08-09,5,24
40,49,89,2019-08-10,6,1
30,32,62,2019-08-10,6,2
22,13,35,2019-08-10,6,3
13,19,32,2019-08-10,6,4
28,29,57,2019-08-10,6,5
51,53,104,2019-08-10,6,6
75,76,151,2019-08-10,6,7
162,146,308,2019-08-10,6,8
270,197,467,2019-08-10,6,9
441,392,833,2019-08-10,6,10
560,530,1090,2019-08-10,6,11
580,645,1225,2019-08-10,6,12
539,585,1124,2019-08-10,6,13
543,604,1147,2019-08-10,6,14
506,529,1035,2019-08-10,6,15
516,515,1031,2019-08-10,6,16
507,438,945,2019-08-10,6,17
436,411,847,2019-08-10,6,18
392,395,787,2019-08-10,6,19
281,321,602,2019-08-10,6,20
196,236,432,2019-08-10,6,21
151,158,309,2019-08-10,6,22
130,128,258,2019-08-10,6,23
89,92,181,2019-08-10,6,24
77,61,138,2019-08-11,7,1
46,38,84,2019-08-11,7,2
18,26,44,2019-08-11,7,3
15,19,34,2019-08-11,7,4
25,30,55,2019-08-11,7,5
63,43,106,2019-08-11,7,6
39,33,72,2019-08-11,7,7
79,79,158,2019-08-11,7,8
160,140,300,2019-08-11,7,9
321,287,608,2019-08-11,7,10
492,400,892,2019-08-11,7,11
552,478,1030,2019-08-11,7,12
685,508,1193,2019-08-11,7,13
604,508,1112,2019-08-11,7,14
600,512,1112,2019-08-11,7,15
520,562,1082,2019-08-11,7,16
491,536,1027,2019-08-11,7,17
420,553,973,2019-08-11,7,18
366,394,760,2019-08-11,7,19
245,343,588,2019-08-11,7,20
173,250,423,2019-08-11,7,21
120,265,385,2019-08-11,7,22
79,172,251,2019-08-11,7,23
23,52,75,2019-08-11,7,24
16,26,42,2019-08-12,1,1
6,26,32,2019-08-12,1,2
13,17,30,2019-08-12,1,3
16,12,28,2019-08-12,1,4
41,39,80,2019-08-12,1,5
233,181,414,2019-08-12,1,6
582,444,1026,2019-08-12,1,7
921,537,1458,2019-08-12,1,8
569,460,1029,2019-08-12,1,9
606,545,1151,2019-08-12,1,10
656,615,1271,2019-08-12,1,11
596,604,1200,2019-08-12,1,12
629,640,1269,2019-08-12,1,13
568,583,1151,2019-08-12,1,14
619,594,1213,2019-08-12,1,15
663,768,1431,2019-08-12,1,16
797,753,1550,2019-08-12,1,17
616,710,1326,2019-08-12,1,18
448,593,1041,2019-08-12,1,19
300,364,664,2019-08-12,1,20
211,252,463,2019-08-12,1,21
155,183,338,2019-08-12,1,22
71,84,155,2019-08-12,1,23
27,43,70,2019-08-12,1,24
27,27,54,2019-08-13,2,1
8,17,25,2019-08-13,2,2
11,16,27,2019-08-13,2,3
14,13,27,2019-08-13,2,4
46,47,93,2019-08-13,2,5
224,186,410,2019-08-13,2,6
599,399,998,2019-08-13,2,7
885,550,1435,2019-08-13,2,8
620,479,1099,2019-08-13,2,9
624,488,1112,2019-08-13,2,10
605,609,1214,2019-08-13,2,11
548,633,1181,2019-08-13,2,12
603,735,1338,2019-08-13,2,13
595,713,1308,2019-08-13,2,14
658,623,1281,2019-08-13,2,15
649,743,1392,2019-08-13,2,16
875,816,1691,2019-08-13,2,17
651,774,1425,2019-08-13,2,18
454,578,1032,2019-08-13,2,19
306,382,688,2019-08-13,2,20
214,272,486,2019-08-13,2,21
152,185,337,2019-08-13,2,22
66,113,179,2019-08-13,2,23
30,38,68,2019-08-13,2,24
24,16,40,2019-08-14,3,1
6,9,15,2019-08-14,3,2
10,10,20,2019-08-14,3,3
13,16,29,2019-08-14,3,4
42,35,77,2019-08-14,3,5
224,177,401,2019-08-14,3,6
606,360,966,2019-08-14,3,7
889,591,1480,2019-08-14,3,8
632,516,1148,2019-08-14,3,9
566,548,1114,2019-08-14,3,10
594,611,1205,2019-08-14,3,11
649,613,1262,2019-08-14,3,12
634,660,1294,2019-08-14,3,13
609,636,1245,2019-08-14,3,14
602,644,1246,2019-08-14,3,15
688,736,1424,2019-08-14,3,16
769,884,1653,2019-08-14,3,17
652,709,1361,2019-08-14,3,18
522,612,1134,2019-08-14,3,19
294,366,660,2019-08-14,3,20
223,265,488,2019-08-14,3,21
127,204,331,2019-08-14,3,22
91,99,190,2019-08-14,3,23
36,49,85,2019-08-14,3,24
25,28,53,2019-08-15,4,1
14,16,30,2019-08-15,4,2
7,8,15,2019-08-15,4,3
12,12,24,2019-08-15,4,4
51,32,83,2019-08-15,4,5
204,160,364,2019-08-15,4,6
582,411,993,2019-08-15,4,7
906,547,1453,2019-08-15,4,8
667,468,1135,2019-08-15,4,9
575,457,1032,2019-08-15,4,10
565,565,1130,2019-08-15,4,11
568,614,1182,2019-08-15,4,12
512,637,1149,2019-08-15,4,13
647,679,1326,2019-08-15,4,14
660,627,1287,2019-08-15,4,15
768,687,1455,2019-08-15,4,16
801,717,1518,2019-08-15,4,17
607,679,1286,2019-08-15,4,18
474,591,1065,2019-08-15,4,19
328,388,716,2019-08-15,4,20
209,262,471,2019-08-15,4,21
145,175,320,2019-08-15,4,22
110,123,233,2019-08-15,4,23
47,55,102,2019-08-15,4,24
18,28,46,2019-08-16,5,1
10,15,25,2019-08-16,5,2
10,10,20,2019-08-16,5,3
13,8,21,2019-08-16,5,4
46,36,82,2019-08-16,5,5
203,165,368,2019-08-16,5,6
544,355,899,2019-08-16,5,7
826,530,1356,2019-08-16,5,8
577,435,1012,2019-08-16,5,9
587,535,1122,2019-08-16,5,10
659,620,1279,2019-08-16,5,11
658,689,1347,2019-08-16,5,12
715,784,1499,2019-08-16,5,13
640,864,1504,2019-08-16,5,14
732,756,1488,2019-08-16,5,15
710,710,1420,2019-08-16,5,16
722,673,1395,2019-08-16,5,17
585,563,1148,2019-08-16,5,18
486,545,1031,2019-08-16,5,19
333,361,694,2019-08-16,5,20
255,279,534,2019-08-16,5,21
172,226,398,2019-08-16,5,22
126,158,284,2019-08-16,5,23
90,127,217,2019-08-16,5,24
52,53,105,2019-08-17,6,1
38,26,64,2019-08-17,6,2
19,30,49,2019-08-17,6,3
15,24,39,2019-08-17,6,4
20,23,43,2019-08-17,6,5
68,60,128,2019-08-17,6,6
98,67,165,2019-08-17,6,7
157,143,300,2019-08-17,6,8
303,221,524,2019-08-17,6,9
494,399,893,2019-08-17,6,10
597,539,1136,2019-08-17,6,11
627,626,1253,2019-08-17,6,12
575,614,1189,2019-08-17,6,13
476,541,1017,2019-08-17,6,14
481,568,1049,2019-08-17,6,15
482,535,1017,2019-08-17,6,16
439,443,882,2019-08-17,6,17
500,467,967,2019-08-17,6,18
359,419,778,2019-08-17,6,19
272,273,545,2019-08-17,6,20
192,235,427,2019-08-17,6,21
200,174,374,2019-08-17,6,22
102,141,243,2019-08-17,6,23
83,67,150,2019-08-17,6,24
63,64,127,2019-08-18,7,1
47,44,91,2019-08-18,7,2
34,32,66,2019-08-18,7,3
17,29,46,2019-08-18,7,4
22,24,46,2019-08-18,7,5
50,42,92,2019-08-18,7,6
60,56,116,2019-08-18,7,7
56,66,122,2019-08-18,7,8
109,115,224,2019-08-18,7,9
219,225,444,2019-08-18,7,10
350,334,684,2019-08-18,7,11
430,419,849,2019-08-18,7,12
487,464,951,2019-08-18,7,13
474,483,957,2019-08-18,7,14
510,514,1024,2019-08-18,7,15
450,449,899,2019-08-18,7,16
419,557,976,2019-08-18,7,17
485,491,976,2019-08-18,7,18
334,379,713,2019-08-18,7,19
234,281,515,2019-08-18,7,20
166,210,376,2019-08-18,7,21
125,151,276,2019-08-18,7,22
57,79,136,2019-08-18,7,23
25,33,58,2019-08-18,7,24
5,18,23,2019-08-19,1,1
14,16,30,2019-08-19,1,2
11,11,22,2019-08-19,1,3
12,18,30,2019-08-19,1,4
57,37,94,2019-08-19,1,5
219,180,399,2019-08-19,1,6
609,510,1119,2019-08-19,1,7
879,539,1418,2019-08-19,1,8
667,493,1160,2019-08-19,1,9
603,585,1188,2019-08-19,1,10
755,741,1496,2019-08-19,1,11
683,790,1473,2019-08-19,1,12
713,797,1510,2019-08-19,1,13
628,789,1417,2019-08-19,1,14
703,758,1461,2019-08-19,1,15
753,828,1581,2019-08-19,1,16
839,836,1675,2019-08-19,1,17
638,748,1386,2019-08-19,1,18
506,690,1196,2019-08-19,1,19
316,380,696,2019-08-19,1,20
198,240,438,2019-08-19,1,21
132,171,303,2019-08-19,1,22
67,89,156,2019-08-19,1,23
40,30,70,2019-08-19,1,24
15,18,33,2019-08-20,2,1
8,11,19,2019-08-20,2,2
11,10,21,2019-08-20,2,3
12,13,25,2019-08-20,2,4
47,35,82,2019-08-20,2,5
226,162,388,2019-08-20,2,6
598,423,1021,2019-08-20,2,7
892,587,1479,2019-08-20,2,8
633,492,1125,2019-08-20,2,9
562,488,1050,2019-08-20,2,10
576,569,1145,2019-08-20,2,11
573,577,1150,2019-08-20,2,12
564,601,1165,2019-08-20,2,13
564,685,1249,2019-08-20,2,14
658,619,1277,2019-08-20,2,15
635,782,1417,2019-08-20,2,16
781,844,1625,2019-08-20,2,17
545,725,1270,2019-08-20,2,18
445,543,988,2019-08-20,2,19
284,394,678,2019-08-20,2,20
207,247,454,2019-08-20,2,21
160,169,329,2019-08-20,2,22
71,113,184,2019-08-20,2,23
29,58,87,2019-08-20,2,24
24,13,37,2019-08-21,3,1
7,12,19,2019-08-21,3,2
11,10,21,2019-08-21,3,3
11,16,27,2019-08-21,3,4
44,41,85,2019-08-21,3,5
191,145,336,2019-08-21,3,6
553,390,943,2019-08-21,3,7
862,538,1400,2019-08-21,3,8
672,472,1144,2019-08-21,3,9
571,503,1074,2019-08-21,3,10
568,562,1130,2019-08-21,3,11
566,595,1161,2019-08-21,3,12
591,648,1239,2019-08-21,3,13
569,648,1217,2019-08-21,3,14
588,640,1228,2019-08-21,3,15
626,739,1365,2019-08-21,3,16
741,736,1477,2019-08-21,3,17
674,700,1374,2019-08-21,3,18
479,551,1030,2019-08-21,3,19
316,340,656,2019-08-21,3,20
230,271,501,2019-08-21,3,21
159,207,366,2019-08-21,3,22
82,110,192,2019-08-21,3,23
29,41,70,2019-08-21,3,24
22,24,46,2019-08-22,4,1
11,20,31,2019-08-22,4,2
10,10,20,2019-08-22,4,3
12,17,29,2019-08-22,4,4
47,30,77,2019-08-22,4,5
194,153,347,2019-08-22,4,6
563,420,983,2019-08-22,4,7
842,516,1358,2019-08-22,4,8
581,454,1035,2019-08-22,4,9
564,508,1072,2019-08-22,4,10
607,570,1177,2019-08-22,4,11
589,604,1193,2019-08-22,4,12
598,581,1179,2019-08-22,4,13
612,658,1270,2019-08-22,4,14
636,606,1242,2019-08-22,4,15
699,758,1457,2019-08-22,4,16
759,776,1535,2019-08-22,4,17
621,715,1336,2019-08-22,4,18
452,567,1019,2019-08-22,4,19
344,440,784,2019-08-22,4,20
224,281,505,2019-08-22,4,21
174,178,352,2019-08-22,4,22
94,131,225,2019-08-22,4,23
38,53,91,2019-08-22,4,24
12,23,35,2019-08-23,5,1
18,25,43,2019-08-23,5,2
8,10,18,2019-08-23,5,3
12,14,26,2019-08-23,5,4
55,35,90,2019-08-23,5,5
206,164,370,2019-08-23,5,6
498,352,850,2019-08-23,5,7
794,527,1321,2019-08-23,5,8
569,428,997,2019-08-23,5,9
546,524,1070,2019-08-23,5,10
650,528,1178,2019-08-23,5,11
707,646,1353,2019-08-23,5,12
762,723,1485,2019-08-23,5,13
645,772,1417,2019-08-23,5,14
669,670,1339,2019-08-23,5,15
700,628,1328,2019-08-23,5,16
716,638,1354,2019-08-23,5,17
571,614,1185,2019-08-23,5,18
462,566,1028,2019-08-23,5,19
327,361,688,2019-08-23,5,20
203,309,512,2019-08-23,5,21
150,258,408,2019-08-23,5,22
131,151,282,2019-08-23,5,23
66,103,169,2019-08-23,5,24
98,72,170,2019-08-24,6,1
45,37,82,2019-08-24,6,2
33,22,55,2019-08-24,6,3
18,15,33,2019-08-24,6,4
19,28,47,2019-08-24,6,5
76,57,133,2019-08-24,6,6
74,79,153,2019-08-24,6,7
163,127,290,2019-08-24,6,8
281,253,534,2019-08-24,6,9
522,437,959,2019-08-24,6,10
639,512,1151,2019-08-24,6,11
656,543,1199,2019-08-24,6,12
658,530,1188,2019-08-24,6,13
577,537,1114,2019-08-24,6,14
531,542,1073,2019-08-24,6,15
482,557,1039,2019-08-24,6,16
395,521,916,2019-08-24,6,17
414,548,962,2019-08-24,6,18
402,488,890,2019-08-24,6,19
245,353,598,2019-08-24,6,20
201,258,459,2019-08-24,6,21
153,207,360,2019-08-24,6,22
149,139,288,2019-08-24,6,23
101,112,213,2019-08-24,6,24
95,68,163,2019-08-25,7,1
71,41,112,2019-08-25,7,2
43,35,78,2019-08-25,7,3
23,23,46,2019-08-25,7,4
21,20,41,2019-08-25,7,5
52,45,97,2019-08-25,7,6
41,45,86,2019-08-25,7,7
81,70,151,2019-08-25,7,8
148,145,293,2019-08-25,7,9
338,273,611,2019-08-25,7,10
519,388,907,2019-08-25,7,11
669,390,1059,2019-08-25,7,12
705,431,1136,2019-08-25,7,13
579,471,1050,2019-08-25,7,14
528,498,1026,2019-08-25,7,15
389,609,998,2019-08-25,7,16
412,623,1035,2019-08-25,7,17
415,742,1157,2019-08-25,7,18
341,628,969,2019-08-25,7,19
286,378,664,2019-08-25,7,20
216,260,476,2019-08-25,7,21
123,162,285,2019-08-25,7,22
57,85,142,2019-08-25,7,23
24,44,68,2019-08-25,7,24
10,29,39,2019-08-26,1,1
4,12,16,2019-08-26,1,2
7,10,17,2019-08-26,1,3
6,13,19,2019-08-26,1,4
57,39,96,2019-08-26,1,5
216,166,382,2019-08-26,1,6
552,401,953,2019-08-26,1,7
841,537,1378,2019-08-26,1,8
593,437,1030,2019-08-26,1,9
547,526,1073,2019-08-26,1,10
575,554,1129,2019-08-26,1,11
578,565,1143,2019-08-26,1,12
534,594,1128,2019-08-26,1,13
591,639,1230,2019-08-26,1,14
626,575,1201,2019-08-26,1,15
638,672,1310,2019-08-26,1,16
782,762,1544,2019-08-26,1,17
580,686,1266,2019-08-26,1,18
402,581,983,2019-08-26,1,19
317,373,690,2019-08-26,1,20
224,258,482,2019-08-26,1,21
145,180,325,2019-08-26,1,22
77,90,167,2019-08-26,1,23
20,27,47,2019-08-26,1,24
7,26,33,2019-08-27,2,1
9,9,18,2019-08-27,2,2
14,13,27,2019-08-27,2,3
9,16,25,2019-08-27,2,4
49,28,77,2019-08-27,2,5
207,170,377,2019-08-27,2,6
595,402,997,2019-08-27,2,7
808,529,1337,2019-08-27,2,8
653,477,1130,2019-08-27,2,9
615,504,1119,2019-08-27,2,10
594,530,1124,2019-08-27,2,11
607,574,1181,2019-08-27,2,12
575,596,1171,2019-08-27,2,13
549,600,1149,2019-08-27,2,14
609,565,1174,2019-08-27,2,15
630,714,1344,2019-08-27,2,16
794,789,1583,2019-08-27,2,17
553,678,1231,2019-08-27,2,18
441,583,1024,2019-08-27,2,19
306,413,719,2019-08-27,2,20
205,282,487,2019-08-27,2,21
163,184,347,2019-08-27,2,22
58,99,157,2019-08-27,2,23
23,33,56,2019-08-27,2,24
18,15,33,2019-08-28,3,1
7,10,17,2019-08-28,3,2
11,10,21,2019-08-28,3,3
4,13,17,2019-08-28,3,4
56,38,94,2019-08-28,3,5
191,168,359,2019-08-28,3,6
531,399,930,2019-08-28,3,7
784,541,1325,2019-08-28,3,8
589,445,1034,2019-08-28,3,9
547,508,1055,2019-08-28,3,10
545,539,1084,2019-08-28,3,11
607,528,1135,2019-08-28,3,12
574,611,1185,2019-08-28,3,13
580,679,1259,2019-08-28,3,14
632,622,1254,2019-08-28,3,15
634,684,1318,2019-08-28,3,16
712,761,1473,2019-08-28,3,17
565,649,1214,2019-08-28,3,18
458,532,990,2019-08-28,3,19
318,401,719,2019-08-28,3,20
202,321,523,2019-08-28,3,21
157,221,378,2019-08-28,3,22
93,114,207,2019-08-28,3,23
48,46,94,2019-08-28,3,24
5,14,19,2019-08-29,4,1
8,9,17,2019-08-29,4,2
7,18,25,2019-08-29,4,3
9,12,21,2019-08-29,4,4
50,37,87,2019-08-29,4,5
187,165,352,2019-08-29,4,6
538,373,911,2019-08-29,4,7
794,483,1277,2019-08-29,4,8
534,454,988,2019-08-29,4,9
544,503,1047,2019-08-29,4,10
548,536,1084,2019-08-29,4,11
530,599,1129,2019-08-29,4,12
510,592,1102,2019-08-29,4,13
546,669,1215,2019-08-29,4,14
602,570,1172,2019-08-29,4,15
693,732,1425,2019-08-29,4,16
777,787,1564,2019-08-29,4,17
588,671,1259,2019-08-29,4,18
452,554,1006,2019-08-29,4,19
322,387,709,2019-08-29,4,20
222,242,464,2019-08-29,4,21
147,182,329,2019-08-29,4,22
92,133,225,2019-08-29,4,23
44,70,114,2019-08-29,4,24
18,21,39,2019-08-30,5,1
9,11,20,2019-08-30,5,2
15,9,24,2019-08-30,5,3
8,12,20,2019-08-30,5,4
49,39,88,2019-08-30,5,5
202,158,360,2019-08-30,5,6
490,354,844,2019-08-30,5,7
763,482,1245,2019-08-30,5,8
545,411,956,2019-08-30,5,9
550,505,1055,2019-08-30,5,10
608,578,1186,2019-08-30,5,11
651,609,1260,2019-08-30,5,12
627,663,1290,2019-08-30,5,13
602,725,1327,2019-08-30,5,14
626,656,1282,2019-08-30,5,15
679,593,1272,2019-08-30,5,16
652,635,1287,2019-08-30,5,17
524,536,1060,2019-08-30,5,18
453,553,1006,2019-08-30,5,19
333,413,746,2019-08-30,5,20
247,241,488,2019-08-30,5,21
230,197,427,2019-08-30,5,22
129,128,257,2019-08-30,5,23
83,121,204,2019-08-30,5,24
48,67,115,2019-08-31,6,1
35,49,84,2019-08-31,6,2
25,28,53,2019-08-31,6,3
10,15,25,2019-08-31,6,4
19,21,40,2019-08-31,6,5
66,46,112,2019-08-31,6,6
84,91,175,2019-08-31,6,7
182,157,339,2019-08-31,6,8
297,233,530,2019-08-31,6,9
508,413,921,2019-08-31,6,10
593,438,1031,2019-08-31,6,11
636,563,1199,2019-08-31,6,12
595,521,1116,2019-08-31,6,13
544,488,1032,2019-08-31,6,14
506,436,942,2019-08-31,6,15
376,444,820,2019-08-31,6,16
392,527,919,2019-08-31,6,17
416,533,949,2019-08-31,6,18
360,470,830,2019-08-31,6,19
264,394,658,2019-08-31,6,20
199,271,470,2019-08-31,6,21
164,203,367,2019-08-31,6,22
110,104,214,2019-08-31,6,23
84,93,177,2019-08-31,6,24
49,75,124,2019-09-01,7,1
39,45,84,2019-09-01,7,2
24,28,52,2019-09-01,7,3
22,27,49,2019-09-01,7,4
19,24,43,2019-09-01,7,5
49,47,96,2019-09-01,7,6
58,43,101,2019-09-01,7,7
89,63,152,2019-09-01,7,8
141,127,268,2019-09-01,7,9
258,266,524,2019-09-01,7,10
425,446,871,2019-09-01,7,11
523,515,1038,2019-09-01,7,12
527,517,1044,2019-09-01,7,13
595,503,1098,2019-09-01,7,14
519,467,986,2019-09-01,7,15
429,483,912,2019-09-01,7,16
403,601,1004,2019-09-01,7,17
401,609,1010,2019-09-01,7,18
303,342,645,2019-09-01,7,19
232,243,475,2019-09-01,7,20
172,208,380,2019-09-01,7,21
109,110,219,2019-09-01,7,22
75,75,150,2019-09-01,7,23
59,47,106,2019-09-01,7,24
14,26,40,2019-09-02,1,1
4,9,13,2019-09-02,1,2
9,7,16,2019-09-02,1,3
11,17,28,2019-09-02,1,4
53,37,90,2019-09-02,1,5
196,171,367,2019-09-02,1,6
560,428,988,2019-09-02,1,7
843,578,1421,2019-09-02,1,8
642,463,1105,2019-09-02,1,9
536,494,1030,2019-09-02,1,10
512,560,1072,2019-09-02,1,11
534,596,1130,2019-09-02,1,12
508,593,1101,2019-09-02,1,13
519,630,1149,2019-09-02,1,14
552,524,1076,2019-09-02,1,15
628,695,1323,2019-09-02,1,16
759,749,1508,2019-09-02,1,17
543,686,1229,2019-09-02,1,18
389,532,921,2019-09-02,1,19
302,304,606,2019-09-02,1,20
211,191,402,2019-09-02,1,21
130,164,294,2019-09-02,1,22
64,77,141,2019-09-02,1,23
15,36,51,2019-09-02,1,24
12,14,26,2019-09-03,2,1
7,10,17,2019-09-03,2,2
13,11,24,2019-09-03,2,3
12,20,32,2019-09-03,2,4
53,33,86,2019-09-03,2,5
209,163,372,2019-09-03,2,6
543,407,950,2019-09-03,2,7
790,514,1304,2019-09-03,2,8
566,405,971,2019-09-03,2,9
511,435,946,2019-09-03,2,10
478,507,985,2019-09-03,2,11
468,528,996,2019-09-03,2,12
497,558,1055,2019-09-03,2,13
516,612,1128,2019-09-03,2,14
611,605,1216,2019-09-03,2,15
590,685,1275,2019-09-03,2,16
740,753,1493,2019-09-03,2,17
584,662,1246,2019-09-03,2,18
443,496,939,2019-09-03,2,19
281,308,589,2019-09-03,2,20
182,243,425,2019-09-03,2,21
147,200,347,2019-09-03,2,22
65,94,159,2019-09-03,2,23
23,35,58,2019-09-03,2,24
12,15,27,2019-09-04,3,1
10,8,18,2019-09-04,3,2
5,9,14,2019-09-04,3,3
11,13,24,2019-09-04,3,4
51,33,84,2019-09-04,3,5
198,157,355,2019-09-04,3,6
534,408,942,2019-09-04,3,7
813,508,1321,2019-09-04,3,8
603,475,1078,2019-09-04,3,9
528,462,990,2019-09-04,3,10
484,530,1014,2019-09-04,3,11
498,532,1030,2019-09-04,3,12
479,558,1037,2019-09-04,3,13
458,553,1011,2019-09-04,3,14
528,542,1070,2019-09-04,3,15
584,727,1311,2019-09-04,3,16
737,719,1456,2019-09-04,3,17
606,684,1290,2019-09-04,3,18
415,507,922,2019-09-04,3,19
266,307,573,2019-09-04,3,20
170,182,352,2019-09-04,3,21
114,159,273,2019-09-04,3,22
75,82,157,2019-09-04,3,23
41,26,67,2019-09-04,3,24
14,12,26,2019-09-05,4,1
5,7,12,2019-09-05,4,2
11,16,27,2019-09-05,4,3
10,13,23,2019-09-05,4,4
51,34,85,2019-09-05,4,5
181,144,325,2019-09-05,4,6
526,413,939,2019-09-05,4,7
783,516,1299,2019-09-05,4,8
546,483,1029,2019-09-05,4,9
552,500,1052,2019-09-05,4,10
510,543,1053,2019-09-05,4,11
553,528,1081,2019-09-05,4,12
510,580,1090,2019-09-05,4,13
515,608,1123,2019-09-05,4,14
582,549,1131,2019-09-05,4,15
680,646,1326,2019-09-05,4,16
757,674,1431,2019-09-05,4,17
667,652,1319,2019-09-05,4,18
485,562,1047,2019-09-05,4,19
280,336,616,2019-09-05,4,20
176,218,394,2019-09-05,4,21
131,164,295,2019-09-05,4,22
74,109,183,2019-09-05,4,23
41,46,87,2019-09-05,4,24
15,18,33,2019-09-06,5,1
7,11,18,2019-09-06,5,2
9,7,16,2019-09-06,5,3
11,12,23,2019-09-06,5,4
43,26,69,2019-09-06,5,5
190,151,341,2019-09-06,5,6
497,374,871,2019-09-06,5,7
762,506,1268,2019-09-06,5,8
560,385,945,2019-09-06,5,9
476,471,947,2019-09-06,5,10
543,521,1064,2019-09-06,5,11
618,635,1253,2019-09-06,5,12
683,713,1396,2019-09-06,5,13
592,707,1299,2019-09-06,5,14
655,651,1306,2019-09-06,5,15
592,609,1201,2019-09-06,5,16
617,598,1215,2019-09-06,5,17
482,535,1017,2019-09-06,5,18
335,458,793,2019-09-06,5,19
298,291,589,2019-09-06,5,20
184,204,388,2019-09-06,5,21
124,143,267,2019-09-06,5,22
95,104,199,2019-09-06,5,23
66,72,138,2019-09-06,5,24
31,51,82,2019-09-07,6,1
37,28,65,2019-09-07,6,2
12,12,24,2019-09-07,6,3
9,17,26,2019-09-07,6,4
17,15,32,2019-09-07,6,5
74,50,124,2019-09-07,6,6
83,71,154,2019-09-07,6,7
139,137,276,2019-09-07,6,8
292,202,494,2019-09-07,6,9
478,370,848,2019-09-07,6,10
544,483,1027,2019-09-07,6,11
529,493,1022,2019-09-07,6,12
583,506,1089,2019-09-07,6,13
543,514,1057,2019-09-07,6,14
499,480,979,2019-09-07,6,15
357,455,812,2019-09-07,6,16
381,424,805,2019-09-07,6,17
374,413,787,2019-09-07,6,18
369,366,735,2019-09-07,6,19
218,284,502,2019-09-07,6,20
177,220,397,2019-09-07,6,21
132,131,263,2019-09-07,6,22
89,119,208,2019-09-07,6,23
59,61,120,2019-09-07,6,24
43,43,86,2019-09-08,7,1
29,35,64,2019-09-08,7,2
37,32,69,2019-09-08,7,3
21,27,48,2019-09-08,7,4
25,29,54,2019-09-08,7,5
44,44,88,2019-09-08,7,6
46,50,96,2019-09-08,7,7
71,55,126,2019-09-08,7,8
126,112,238,2019-09-08,7,9
282,254,536,2019-09-08,7,10
343,320,663,2019-09-08,7,11
402,372,774,2019-09-08,7,12
466,279,745,2019-09-08,7,13
441,440,881,2019-09-08,7,14
482,468,950,2019-09-08,7,15
394,443,837,2019-09-08,7,16
352,457,809,2019-09-08,7,17
354,526,880,2019-09-08,7,18
304,336,640,2019-09-08,7,19
193,254,447,2019-09-08,7,20
148,164,312,2019-09-08,7,21
99,94,193,2019-09-08,7,22
39,52,91,2019-09-08,7,23
21,25,46,2019-09-08,7,24
11,28,39,2019-09-09,1,1
8,9,17,2019-09-09,1,2
9,14,23,2019-09-09,1,3
8,18,26,2019-09-09,1,4
56,33,89,2019-09-09,1,5
190,157,347,2019-09-09,1,6
552,404,956,2019-09-09,1,7
825,510,1335,2019-09-09,1,8
568,432,1000,2019-09-09,1,9
558,489,1047,2019-09-09,1,10
514,583,1097,2019-09-09,1,11
524,564,1088,2019-09-09,1,12
553,589,1142,2019-09-09,1,13
507,617,1124,2019-09-09,1,14
595,572,1167,2019-09-09,1,15
603,660,1263,2019-09-09,1,16
810,737,1547,2019-09-09,1,17
577,650,1227,2019-09-09,1,18
431,537,968,2019-09-09,1,19
283,331,614,2019-09-09,1,20
156,235,391,2019-09-09,1,21
102,155,257,2019-09-09,1,22
55,77,132,2019-09-09,1,23
27,21,48,2019-09-09,1,24
13,15,28,2019-09-10,2,1
10,8,18,2019-09-10,2,2
8,13,21,2019-09-10,2,3
8,10,18,2019-09-10,2,4
51,30,81,2019-09-10,2,5
180,151,331,2019-09-10,2,6
568,402,970,2019-09-10,2,7
848,542,1390,2019-09-10,2,8
645,619,1264,2019-09-10,2,9
592,640,1232,2019-09-10,2,10
550,613,1163,2019-09-10,2,11
487,560,1047,2019-09-10,2,12
564,607,1171,2019-09-10,2,13
530,639,1169,2019-09-10,2,14
667,608,1275,2019-09-10,2,15
691,684,1375,2019-09-10,2,16
817,794,1611,2019-09-10,2,17
671,643,1314,2019-09-10,2,18
447,569,1016,2019-09-10,2,19
291,329,620,2019-09-10,2,20
174,223,397,2019-09-10,2,21
130,151,281,2019-09-10,2,22
56,81,137,2019-09-10,2,23
25,34,59,2019-09-10,2,24
12,19,31,2019-09-11,3,1
12,5,17,2019-09-11,3,2
12,18,30,2019-09-11,3,3
11,17,28,2019-09-11,3,4
60,35,95,2019-09-11,3,5
203,153,356,2019-09-11,3,6
567,398,965,2019-09-11,3,7
812,561,1373,2019-09-11,3,8
610,480,1090,2019-09-11,3,9
554,467,1021,2019-09-11,3,10
578,545,1123,2019-09-11,3,11
575,555,1130,2019-09-11,3,12
570,580,1150,2019-09-11,3,13
606,618,1224,2019-09-11,3,14
640,686,1326,2019-09-11,3,15
747,725,1472,2019-09-11,3,16
755,755,1510,2019-09-11,3,17
644,664,1308,2019-09-11,3,18
427,531,958,2019-09-11,3,19
309,378,687,2019-09-11,3,20
189,240,429,2019-09-11,3,21
124,140,264,2019-09-11,3,22
72,83,155,2019-09-11,3,23
23,39,62,2019-09-11,3,24
25,19,44,2019-09-12,4,1
5,12,17,2019-09-12,4,2
11,10,21,2019-09-12,4,3
15,17,32,2019-09-12,4,4
45,33,78,2019-09-12,4,5
194,154,348,2019-09-12,4,6
566,414,980,2019-09-12,4,7
849,569,1418,2019-09-12,4,8
668,512,1180,2019-09-12,4,9
582,558,1140,2019-09-12,4,10
578,595,1173,2019-09-12,4,11
558,561,1119,2019-09-12,4,12
612,671,1283,2019-09-12,4,13
681,694,1375,2019-09-12,4,14
665,641,1306,2019-09-12,4,15
781,726,1507,2019-09-12,4,16
842,777,1619,2019-09-12,4,17
690,717,1407,2019-09-12,4,18
483,520,1003,2019-09-12,4,19
303,348,651,2019-09-12,4,20
232,299,531,2019-09-12,4,21
169,224,393,2019-09-12,4,22
90,108,198,2019-09-12,4,23
26,41,67,2019-09-12,4,24
12,26,38,2019-09-13,5,1
9,16,25,2019-09-13,5,2
12,14,26,2019-09-13,5,3
13,15,28,2019-09-13,5,4
56,43,99,2019-09-13,5,5
165,143,308,2019-09-13,5,6
462,370,832,2019-09-13,5,7
758,526,1284,2019-09-13,5,8
571,422,993,2019-09-13,5,9
494,458,952,2019-09-13,5,10
559,535,1094,2019-09-13,5,11
640,606,1246,2019-09-13,5,12
679,671,1350,2019-09-13,5,13
647,745,1392,2019-09-13,5,14
676,619,1295,2019-09-13,5,15
571,635,1206,2019-09-13,5,16
578,660,1238,2019-09-13,5,17
510,570,1080,2019-09-13,5,18
378,479,857,2019-09-13,5,19
296,336,632,2019-09-13,5,20
201,212,413,2019-09-13,5,21
125,174,299,2019-09-13,5,22
89,141,230,2019-09-13,5,23
50,70,120,2019-09-13,5,24
30,27,57,2019-09-14,6,1
24,37,61,2019-09-14,6,2
18,17,35,2019-09-14,6,3
15,17,32,2019-09-14,6,4
18,32,50,2019-09-14,6,5
73,40,113,2019-09-14,6,6
74,79,153,2019-09-14,6,7
122,136,258,2019-09-14,6,8
305,222,527,2019-09-14,6,9
466,359,825,2019-09-14,6,10
514,495,1009,2019-09-14,6,11
538,543,1081,2019-09-14,6,12
531,473,1004,2019-09-14,6,13
450,469,919,2019-09-14,6,14
472,433,905,2019-09-14,6,15
384,444,828,2019-09-14,6,16
390,486,876,2019-09-14,6,17
410,441,851,2019-09-14,6,18
341,370,711,2019-09-14,6,19
276,261,537,2019-09-14,6,20
187,200,387,2019-09-14,6,21
123,153,276,2019-09-14,6,22
84,108,192,2019-09-14,6,23
47,59,106,2019-09-14,6,24
42,52,94,2019-09-15,7,1
36,32,68,2019-09-15,7,2
15,12,27,2019-09-15,7,3
15,20,35,2019-09-15,7,4
16,20,36,2019-09-15,7,5
54,38,92,2019-09-15,7,6
43,43,86,2019-09-15,7,7
54,67,121,2019-09-15,7,8
127,125,252,2019-09-15,7,9
303,208,511,2019-09-15,7,10
392,347,739,2019-09-15,7,11
475,395,870,2019-09-15,7,12
432,473,905,2019-09-15,7,13
456,434,890,2019-09-15,7,14
569,488,1057,2019-09-15,7,15
452,462,914,2019-09-15,7,16
421,490,911,2019-09-15,7,17
393,505,898,2019-09-15,7,18
270,355,625,2019-09-15,7,19
230,241,471,2019-09-15,7,20
145,176,321,2019-09-15,7,21
98,126,224,2019-09-15,7,22
68,64,132,2019-09-15,7,23
16,33,49,2019-09-15,7,24
9,31,40,2019-09-16,1,1
9,21,30,2019-09-16,1,2
11,15,26,2019-09-16,1,3
14,16,30,2019-09-16,1,4
51,39,90,2019-09-16,1,5
195,146,341,2019-09-16,1,6
548,383,931,2019-09-16,1,7
815,524,1339,2019-09-16,1,8
580,449,1029,2019-09-16,1,9
501,452,953,2019-09-16,1,10
520,549,1069,2019-09-16,1,11
519,532,1051,2019-09-16,1,12
567,527,1094,2019-09-16,1,13
478,605,1083,2019-09-16,1,14
535,577,1112,2019-09-16,1,15
613,663,1276,2019-09-16,1,16
706,747,1453,2019-09-16,1,17
534,674,1208,2019-09-16,1,18
374,441,815,2019-09-16,1,19
283,269,552,2019-09-16,1,20
164,200,364,2019-09-16,1,21
90,134,224,2019-09-16,1,22
41,76,117,2019-09-16,1,23
21,22,43,2019-09-16,1,24
4,14,18,2019-09-17,2,1
9,11,20,2019-09-17,2,2
6,11,17,2019-09-17,2,3
9,12,21,2019-09-17,2,4
47,35,82,2019-09-17,2,5
199,135,334,2019-09-17,2,6
528,404,932,2019-09-17,2,7
833,545,1378,2019-09-17,2,8
594,495,1089,2019-09-17,2,9
520,451,971,2019-09-17,2,10
492,522,1014,2019-09-17,2,11
542,545,1087,2019-09-17,2,12
492,591,1083,2019-09-17,2,13
475,600,1075,2019-09-17,2,14
583,562,1145,2019-09-17,2,15
593,683,1276,2019-09-17,2,16
661,739,1400,2019-09-17,2,17
546,656,1202,2019-09-17,2,18
382,500,882,2019-09-17,2,19
285,309,594,2019-09-17,2,20
142,194,336,2019-09-17,2,21
101,125,226,2019-09-17,2,22
55,74,129,2019-09-17,2,23
36,27,63,2019-09-17,2,24
16,17,33,2019-09-18,3,1
10,11,21,2019-09-18,3,2
5,16,21,2019-09-18,3,3
12,12,24,2019-09-18,3,4
46,35,81,2019-09-18,3,5
184,139,323,2019-09-18,3,6
516,397,913,2019-09-18,3,7
813,542,1355,2019-09-18,3,8
567,464,1031,2019-09-18,3,9
546,463,1009,2019-09-18,3,10
526,528,1054,2019-09-18,3,11
531,567,1098,2019-09-18,3,12
571,601,1172,2019-09-18,3,13
569,609,1178,2019-09-18,3,14
551,656,1207,2019-09-18,3,15
636,696,1332,2019-09-18,3,16
705,765,1470,2019-09-18,3,17
540,636,1176,2019-09-18,3,18
383,477,860,2019-09-18,3,19
260,280,540,2019-09-18,3,20
185,211,396,2019-09-18,3,21
125,166,291,2019-09-18,3,22
42,74,116,2019-09-18,3,23
29,27,56,2019-09-18,3,24
19,12,31,2019-09-19,4,1
5,9,14,2019-09-19,4,2
10,12,22,2019-09-19,4,3
13,12,25,2019-09-19,4,4
49,33,82,2019-09-19,4,5
189,133,322,2019-09-19,4,6
515,386,901,2019-09-19,4,7
806,528,1334,2019-09-19,4,8
591,442,1033,2019-09-19,4,9
522,445,967,2019-09-19,4,10
538,529,1067,2019-09-19,4,11
466,534,1000,2019-09-19,4,12
525,514,1039,2019-09-19,4,13
597,577,1174,2019-09-19,4,14
619,599,1218,2019-09-19,4,15
623,706,1329,2019-09-19,4,16
708,744,1452,2019-09-19,4,17
569,633,1202,2019-09-19,4,18
389,513,902,2019-09-19,4,19
286,320,606,2019-09-19,4,20
186,233,419,2019-09-19,4,21
113,168,281,2019-09-19,4,22
74,90,164,2019-09-19,4,23
23,42,65,2019-09-19,4,24
27,28,55,2019-09-20,5,1
14,11,25,2019-09-20,5,2
15,10,25,2019-09-20,5,3
11,11,22,2019-09-20,5,4
47,27,74,2019-09-20,5,5
195,146,341,2019-09-20,5,6
467,337,804,2019-09-20,5,7
750,496,1246,2019-09-20,5,8
593,422,1015,2019-09-20,5,9
503,469,972,2019-09-20,5,10
553,561,1114,2019-09-20,5,11
550,603,1153,2019-09-20,5,12
603,708,1311,2019-09-20,5,13
595,660,1255,2019-09-20,5,14
606,684,1290,2019-09-20,5,15
593,550,1143,2019-09-20,5,16
580,611,1191,2019-09-20,5,17
451,543,994,2019-09-20,5,18
372,440,812,2019-09-20,5,19
309,279,588,2019-09-20,5,20
172,218,390,2019-09-20,5,21
112,196,308,2019-09-20,5,22
48,20,68,2019-09-20,5,23
110,105,215,2019-09-20,5,24
46,37,83,2019-09-21,6,1
13,25,38,2019-09-21,6,2
15,12,27,2019-09-21,6,3
14,19,33,2019-09-21,6,4
28,25,53,2019-09-21,6,5
61,52,113,2019-09-21,6,6
69,58,127,2019-09-21,6,7
127,110,237,2019-09-21,6,8
258,223,481,2019-09-21,6,9
401,382,783,2019-09-21,6,10
526,486,1012,2019-09-21,6,11
544,480,1024,2019-09-21,6,12
531,464,995,2019-09-21,6,13
484,443,927,2019-09-21,6,14
418,453,871,2019-09-21,6,15
392,406,798,2019-09-21,6,16
374,411,785,2019-09-21,6,17
375,456,831,2019-09-21,6,18
371,358,729,2019-09-21,6,19
227,246,473,2019-09-21,6,20
171,204,375,2019-09-21,6,21
114,128,242,2019-09-21,6,22
84,102,186,2019-09-21,6,23
55,72,127,2019-09-21,6,24
43,43,86,2019-09-22,7,1
26,31,57,2019-09-22,7,2
15,21,36,2019-09-22,7,3
12,22,34,2019-09-22,7,4
25,27,52,2019-09-22,7,5
47,49,96,2019-09-22,7,6
43,48,91,2019-09-22,7,7
70,69,139,2019-09-22,7,8
164,114,278,2019-09-22,7,9
340,254,594,2019-09-22,7,10
495,403,898,2019-09-22,7,11
615,445,1060,2019-09-22,7,12
669,432,1101,2019-09-22,7,13
688,456,1144,2019-09-22,7,14
626,516,1142,2019-09-22,7,15
463,561,1024,2019-09-22,7,16
393,653,1046,2019-09-22,7,17
389,624,1013,2019-09-22,7,18
357,390,747,2019-09-22,7,19
252,312,564,2019-09-22,7,20
152,167,319,2019-09-22,7,21
94,126,220,2019-09-22,7,22
37,51,88,2019-09-22,7,23
16,33,49,2019-09-22,7,24
14,24,38,2019-09-23,1,1
8,7,15,2019-09-23,1,2
5,10,15,2019-09-23,1,3
14,17,31,2019-09-23,1,4
58,39,97,2019-09-23,1,5
194,157,351,2019-09-23,1,6
573,403,976,2019-09-23,1,7
848,536,1384,2019-09-23,1,8
569,438,1007,2019-09-23,1,9
556,483,1039,2019-09-23,1,10
537,508,1045,2019-09-23,1,11
519,540,1059,2019-09-23,1,12
494,549,1043,2019-09-23,1,13
531,586,1117,2019-09-23,1,14
531,515,1046,2019-09-23,1,15
612,671,1283,2019-09-23,1,16
720,792,1512,2019-09-23,1,17
542,693,1235,2019-09-23,1,18
357,459,816,2019-09-23,1,19
271,296,567,2019-09-23,1,20
140,198,338,2019-09-23,1,21
87,132,219,2019-09-23,1,22
48,60,108,2019-09-23,1,23
23,27,50,2019-09-23,1,24
11,17,28,2019-09-24,2,1
8,11,19,2019-09-24,2,2
7,9,16,2019-09-24,2,3
12,11,23,2019-09-24,2,4
43,34,77,2019-09-24,2,5
184,144,328,2019-09-24,2,6
560,398,958,2019-09-24,2,7
812,511,1323,2019-09-24,2,8
565,442,1007,2019-09-24,2,9
496,470,966,2019-09-24,2,10
483,485,968,2019-09-24,2,11
510,538,1048,2019-09-24,2,12
536,539,1075,2019-09-24,2,13
465,612,1077,2019-09-24,2,14
510,524,1034,2019-09-24,2,15
563,664,1227,2019-09-24,2,16
710,754,1464,2019-09-24,2,17
551,705,1256,2019-09-24,2,18
411,518,929,2019-09-24,2,19
283,331,614,2019-09-24,2,20
165,205,370,2019-09-24,2,21
107,112,219,2019-09-24,2,22
60,88,148,2019-09-24,2,23
16,32,48,2019-09-24,2,24
20,12,32,2019-09-25,3,1
9,16,25,2019-09-25,3,2
6,5,11,2019-09-25,3,3
11,11,22,2019-09-25,3,4
45,32,77,2019-09-25,3,5
193,137,330,2019-09-25,3,6
555,373,928,2019-09-25,3,7
770,537,1307,2019-09-25,3,8
596,420,1016,2019-09-25,3,9
549,435,984,2019-09-25,3,10
510,473,983,2019-09-25,3,11
458,505,963,2019-09-25,3,12
544,523,1067,2019-09-25,3,13
472,642,1114,2019-09-25,3,14
524,606,1130,2019-09-25,3,15
513,685,1198,2019-09-25,3,16
760,721,1481,2019-09-25,3,17
569,651,1220,2019-09-25,3,18
434,478,912,2019-09-25,3,19
240,313,553,2019-09-25,3,20
170,219,389,2019-09-25,3,21
88,179,267,2019-09-25,3,22
59,77,136,2019-09-25,3,23
34,27,61,2019-09-25,3,24
21,15,36,2019-09-26,4,1
6,17,23,2019-09-26,4,2
13,9,22,2019-09-26,4,3
12,13,25,2019-09-26,4,4
44,39,83,2019-09-26,4,5
190,140,330,2019-09-26,4,6
552,388,940,2019-09-26,4,7
807,541,1348,2019-09-26,4,8
567,463,1030,2019-09-26,4,9
492,468,960,2019-09-26,4,10
506,546,1052,2019-09-26,4,11
535,559,1094,2019-09-26,4,12
520,525,1045,2019-09-26,4,13
495,674,1169,2019-09-26,4,14
537,579,1116,2019-09-26,4,15
698,675,1373,2019-09-26,4,16
769,724,1493,2019-09-26,4,17
504,690,1194,2019-09-26,4,18
377,508,885,2019-09-26,4,19
261,305,566,2019-09-26,4,20
156,201,357,2019-09-26,4,21
152,140,292,2019-09-26,4,22
74,93,167,2019-09-26,4,23
26,45,71,2019-09-26,4,24
15,17,32,2019-09-27,5,1
9,13,22,2019-09-27,5,2
8,12,20,2019-09-27,5,3
16,12,28,2019-09-27,5,4
42,34,76,2019-09-27,5,5
197,126,323,2019-09-27,5,6
462,385,847,2019-09-27,5,7
738,556,1294,2019-09-27,5,8
531,441,972,2019-09-27,5,9
529,460,989,2019-09-27,5,10
491,481,972,2019-09-27,5,11
578,569,1147,2019-09-27,5,12
601,669,1270,2019-09-27,5,13
612,691,1303,2019-09-27,5,14
620,651,1271,2019-09-27,5,15
643,608,1251,2019-09-27,5,16
580,601,1181,2019-09-27,5,17
496,503,999,2019-09-27,5,18
369,432,801,2019-09-27,5,19
250,297,547,2019-09-27,5,20
147,232,379,2019-09-27,5,21
123,157,280,2019-09-27,5,22
89,102,191,2019-09-27,5,23
51,68,119,2019-09-27,5,24
30,44,74,2019-09-28,6,1
24,30,54,2019-09-28,6,2
11,18,29,2019-09-28,6,3
8,9,17,2019-09-28,6,4
23,22,45,2019-09-28,6,5
72,52,124,2019-09-28,6,6
72,66,138,2019-09-28,6,7
127,122,249,2019-09-28,6,8
257,237,494,2019-09-28,6,9
439,313,752,2019-09-28,6,10
535,428,963,2019-09-28,6,11
533,503,1036,2019-09-28,6,12
496,500,996,2019-09-28,6,13
428,470,898,2019-09-28,6,14
398,455,853,2019-09-28,6,15
381,434,815,2019-09-28,6,16
368,424,792,2019-09-28,6,17
401,424,825,2019-09-28,6,18
307,371,678,2019-09-28,6,19
193,287,480,2019-09-28,6,20
154,173,327,2019-09-28,6,21
97,139,236,2019-09-28,6,22
89,96,185,2019-09-28,6,23
75,71,146,2019-09-28,6,24
55,57,112,2019-09-29,7,1
33,38,71,2019-09-29,7,2
14,31,45,2019-09-29,7,3
22,22,44,2019-09-29,7,4
20,23,43,2019-09-29,7,5
45,39,84,2019-09-29,7,6
33,39,72,2019-09-29,7,7
43,49,92,2019-09-29,7,8
99,76,175,2019-09-29,7,9
198,189,387,2019-09-29,7,10
279,254,533,2019-09-29,7,11
360,405,765,2019-09-29,7,12
412,348,760,2019-09-29,7,13
330,404,734,2019-09-29,7,14
364,389,753,2019-09-29,7,15
313,344,657,2019-09-29,7,16
320,410,730,2019-09-29,7,17
349,370,719,2019-09-29,7,18
241,251,492,2019-09-29,7,19
146,195,341,2019-09-29,7,20
100,127,227,2019-09-29,7,21
76,94,170,2019-09-29,7,22
39,58,97,2019-09-29,7,23
8,28,36,2019-09-29,7,24
11,14,25,2019-09-30,1,1
3,15,18,2019-09-30,1,2
6,13,19,2019-09-30,1,3
10,11,21,2019-09-30,1,4
61,39,100,2019-09-30,1,5
206,171,377,2019-09-30,1,6
537,394,931,2019-09-30,1,7
808,549,1357,2019-09-30,1,8
548,456,1004,2019-09-30,1,9
482,486,968,2019-09-30,1,10
528,511,1039,2019-09-30,1,11
498,542,1040,2019-09-30,1,12
510,550,1060,2019-09-30,1,13
541,601,1142,2019-09-30,1,14
498,579,1077,2019-09-30,1,15
601,663,1264,2019-09-30,1,16
678,736,1414,2019-09-30,1,17
561,623,1184,2019-09-30,1,18
375,489,864,2019-09-30,1,19
284,308,592,2019-09-30,1,20
160,209,369,2019-09-30,1,21
97,139,236,2019-09-30,1,22
55,74,129,2019-09-30,1,23
25,27,52,2019-09-30,1,24
10,10,20,2019-10-01,2,1
10,10,20,2019-10-01,2,2
4,8,12,2019-10-01,2,3
8,13,21,2019-10-01,2,4
45,29,74,2019-10-01,2,5
187,139,326,2019-10-01,2,6
529,370,899,2019-10-01,2,7
768,541,1309,2019-10-01,2,8
594,397,991,2019-10-01,2,9
503,451,954,2019-10-01,2,10
504,535,1039,2019-10-01,2,11
523,533,1056,2019-10-01,2,12
489,539,1028,2019-10-01,2,13
499,611,1110,2019-10-01,2,14
532,580,1112,2019-10-01,2,15
567,674,1241,2019-10-01,2,16
678,658,1336,2019-10-01,2,17
517,655,1172,2019-10-01,2,18
404,501,905,2019-10-01,2,19
263,297,560,2019-10-01,2,20
167,205,372,2019-10-01,2,21
121,136,257,2019-10-01,2,22
55,89,144,2019-10-01,2,23
28,32,60,2019-10-01,2,24
16,16,32,2019-10-02,3,1
4,11,15,2019-10-02,3,2
8,9,17,2019-10-02,3,3
9,13,22,2019-10-02,3,4
47,39,86,2019-10-02,3,5
203,137,340,2019-10-02,3,6
521,374,895,2019-10-02,3,7
794,524,1318,2019-10-02,3,8
584,419,1003,2019-10-02,3,9
508,431,939,2019-10-02,3,10
501,523,1024,2019-10-02,3,11
534,555,1089,2019-10-02,3,12
575,626,1201,2019-10-02,3,13
599,675,1274,2019-10-02,3,14
544,650,1194,2019-10-02,3,15
635,683,1318,2019-10-02,3,16
710,765,1475,2019-10-02,3,17
580,631,1211,2019-10-02,3,18
441,463,904,2019-10-02,3,19
307,377,684,2019-10-02,3,20
200,219,419,2019-10-02,3,21
127,166,293,2019-10-02,3,22
84,106,190,2019-10-02,3,23
41,53,94,2019-10-02,3,24
37,50,87,2019-10-03,4,1
40,30,70,2019-10-03,4,2
20,24,44,2019-10-03,4,3
18,26,44,2019-10-03,4,4
25,18,43,2019-10-03,4,5
52,48,100,2019-10-03,4,6
44,51,95,2019-10-03,4,7
70,75,145,2019-10-03,4,8
119,142,261,2019-10-03,4,9
251,220,471,2019-10-03,4,10
363,301,664,2019-10-03,4,11
413,353,766,2019-10-03,4,12
440,375,815,2019-10-03,4,13
468,372,840,2019-10-03,4,14
418,422,840,2019-10-03,4,15
390,446,836,2019-10-03,4,16
344,477,821,2019-10-03,4,17
340,408,748,2019-10-03,4,18
295,313,608,2019-10-03,4,19
246,214,460,2019-10-03,4,20
122,167,289,2019-10-03,4,21
26,45,71,2019-10-03,4,22
49,64,113,2019-10-03,4,23
20,69,89,2019-10-03,4,24
10,22,32,2019-10-04,5,1
9,13,22,2019-10-04,5,2
14,8,22,2019-10-04,5,3
9,8,17,2019-10-04,5,4
36,37,73,2019-10-04,5,5
116,82,198,2019-10-04,5,6
223,145,368,2019-10-04,5,7
368,244,612,2019-10-04,5,8
377,314,691,2019-10-04,5,9
523,470,993,2019-10-04,5,10
582,547,1129,2019-10-04,5,11
553,552,1105,2019-10-04,5,12
561,593,1154,2019-10-04,5,13
527,555,1082,2019-10-04,5,14
495,567,1062,2019-10-04,5,15
531,548,1079,2019-10-04,5,16
498,484,982,2019-10-04,5,17
517,463,980,2019-10-04,5,18
437,368,805,2019-10-04,5,19
301,262,563,2019-10-04,5,20
153,197,350,2019-10-04,5,21
110,129,239,2019-10-04,5,22
66,87,153,2019-10-04,5,23
49,66,115,2019-10-04,5,24
29,31,60,2019-10-05,6,1
29,25,54,2019-10-05,6,2
18,13,31,2019-10-05,6,3
7,20,27,2019-10-05,6,4
22,20,42,2019-10-05,6,5
73,48,121,2019-10-05,6,6
61,71,132,2019-10-05,6,7
116,82,198,2019-10-05,6,8
250,215,465,2019-10-05,6,9
439,360,799,2019-10-05,6,10
502,506,1008,2019-10-05,6,11
519,543,1062,2019-10-05,6,12
491,588,1079,2019-10-05,6,13
413,636,1049,2019-10-05,6,14
394,592,986,2019-10-05,6,15
379,467,846,2019-10-05,6,16
340,472,812,2019-10-05,6,17
371,403,774,2019-10-05,6,18
296,323,619,2019-10-05,6,19
203,210,413,2019-10-05,6,20
122,133,255,2019-10-05,6,21
77,111,188,2019-10-05,6,22
73,80,153,2019-10-05,6,23
49,55,104,2019-10-05,6,24
38,45,83,2019-10-06,7,1
33,28,61,2019-10-06,7,2
21,26,47,2019-10-06,7,3
13,21,34,2019-10-06,7,4
19,15,34,2019-10-06,7,5
52,56,108,2019-10-06,7,6
43,51,94,2019-10-06,7,7
53,48,101,2019-10-06,7,8
108,97,205,2019-10-06,7,9
287,204,491,2019-10-06,7,10
435,357,792,2019-10-06,7,11
632,389,1021,2019-10-06,7,12
602,451,1053,2019-10-06,7,13
559,478,1037,2019-10-06,7,14
518,576,1094,2019-10-06,7,15
400,589,989,2019-10-06,7,16
350,621,971,2019-10-06,7,17
310,505,815,2019-10-06,7,18
248,246,494,2019-10-06,7,19
177,184,361,2019-10-06,7,20
133,146,279,2019-10-06,7,21
64,96,160,2019-10-06,7,22
38,58,96,2019-10-06,7,23
30,43,73,2019-10-06,7,24
12,17,29,2019-10-07,1,1
1,16,17,2019-10-07,1,2
9,14,23,2019-10-07,1,3
7,16,23,2019-10-07,1,4
43,36,79,2019-10-07,1,5
177,135,312,2019-10-07,1,6
494,395,889,2019-10-07,1,7
586,416,1002,2019-10-07,1,8
507,392,899,2019-10-07,1,9
509,487,996,2019-10-07,1,10
543,532,1075,2019-10-07,1,11
519,552,1071,2019-10-07,1,12
506,475,981,2019-10-07,1,13
488,537,1025,2019-10-07,1,14
496,535,1031,2019-10-07,1,15
535,632,1167,2019-10-07,1,16
719,749,1468,2019-10-07,1,17
510,557,1067,2019-10-07,1,18
400,443,843,2019-10-07,1,19
238,274,512,2019-10-07,1,20
134,158,292,2019-10-07,1,21
80,114,194,2019-10-07,1,22
46,75,121,2019-10-07,1,23
2,3,5,2019-10-07,1,24
12,9,21,2019-10-08,2,1
7,14,21,2019-10-08,2,2
8,8,16,2019-10-08,2,3
14,17,31,2019-10-08,2,4
30,39,69,2019-10-08,2,5
199,141,340,2019-10-08,2,6
463,382,845,2019-10-08,2,7
624,419,1043,2019-10-08,2,8
444,417,861,2019-10-08,2,9
441,395,836,2019-10-08,2,10
460,469,929,2019-10-08,2,11
530,500,1030,2019-10-08,2,12
475,479,954,2019-10-08,2,13
474,555,1029,2019-10-08,2,14
533,551,1084,2019-10-08,2,15
572,657,1229,2019-10-08,2,16
675,686,1361,2019-10-08,2,17
508,590,1098,2019-10-08,2,18
346,426,772,2019-10-08,2,19
235,267,502,2019-10-08,2,20
147,164,311,2019-10-08,2,21
73,111,184,2019-10-08,2,22
55,61,116,2019-10-08,2,23
19,27,46,2019-10-08,2,24
10,15,25,2019-10-09,3,1
8,15,23,2019-10-09,3,2
12,8,20,2019-10-09,3,3
9,10,19,2019-10-09,3,4
45,44,89,2019-10-09,3,5
195,143,338,2019-10-09,3,6
470,367,837,2019-10-09,3,7
578,432,1010,2019-10-09,3,8
493,385,878,2019-10-09,3,9
480,458,938,2019-10-09,3,10
523,544,1067,2019-10-09,3,11
559,500,1059,2019-10-09,3,12
520,508,1028,2019-10-09,3,13
485,546,1031,2019-10-09,3,14
488,564,1052,2019-10-09,3,15
530,666,1196,2019-10-09,3,16
666,676,1342,2019-10-09,3,17
501,558,1059,2019-10-09,3,18
382,456,838,2019-10-09,3,19
250,256,506,2019-10-09,3,20
134,147,281,2019-10-09,3,21
97,128,225,2019-10-09,3,22
62,63,125,2019-10-09,3,23
20,35,55,2019-10-09,3,24
16,24,40,2019-10-10,4,1
9,15,24,2019-10-10,4,2
12,7,19,2019-10-10,4,3
10,14,24,2019-10-10,4,4
44,37,81,2019-10-10,4,5
181,152,333,2019-10-10,4,6
472,349,821,2019-10-10,4,7
598,406,1004,2019-10-10,4,8
475,374,849,2019-10-10,4,9
466,418,884,2019-10-10,4,10
483,446,929,2019-10-10,4,11
495,513,1008,2019-10-10,4,12
541,525,1066,2019-10-10,4,13
511,549,1060,2019-10-10,4,14
546,594,1140,2019-10-10,4,15
602,637,1239,2019-10-10,4,16
657,678,1335,2019-10-10,4,17
537,615,1152,2019-10-10,4,18
359,443,802,2019-10-10,4,19
218,294,512,2019-10-10,4,20
128,185,313,2019-10-10,4,21
97,124,221,2019-10-10,4,22
64,73,137,2019-10-10,4,23
20,49,69,2019-10-10,4,24
11,13,24,2019-10-11,5,1
5,8,13,2019-10-11,5,2
7,5,12,2019-10-11,5,3
14,18,32,2019-10-11,5,4
46,33,79,2019-10-11,5,5
180,134,314,2019-10-11,5,6
443,325,768,2019-10-11,5,7
535,373,908,2019-10-11,5,8
436,344,780,2019-10-11,5,9
469,416,885,2019-10-11,5,10
560,521,1081,2019-10-11,5,11
585,547,1132,2019-10-11,5,12
596,621,1217,2019-10-11,5,13
578,644,1222,2019-10-11,5,14
617,647,1264,2019-10-11,5,15
574,548,1122,2019-10-11,5,16
549,591,1140,2019-10-11,5,17
448,424,872,2019-10-11,5,18
390,334,724,2019-10-11,5,19
226,247,473,2019-10-11,5,20
115,156,271,2019-10-11,5,21
89,117,206,2019-10-11,5,22
72,110,182,2019-10-11,5,23
51,61,112,2019-10-11,5,24
9,9,18,2019-10-12,6,1
14,22,36,2019-10-12,6,2
14,12,26,2019-10-12,6,3
12,9,21,2019-10-12,6,4
25,27,52,2019-10-12,6,5
60,50,110,2019-10-12,6,6
65,56,121,2019-10-12,6,7
113,91,204,2019-10-12,6,8
214,188,402,2019-10-12,6,9
339,279,618,2019-10-12,6,10
455,406,861,2019-10-12,6,11
545,480,1025,2019-10-12,6,12
623,501,1124,2019-10-12,6,13
619,511,1130,2019-10-12,6,14
637,450,1087,2019-10-12,6,15
552,427,979,2019-10-12,6,16
606,379,985,2019-10-12,6,17
492,351,843,2019-10-12,6,18
348,278,626,2019-10-12,6,19
200,211,411,2019-10-12,6,20
128,174,302,2019-10-12,6,21
100,123,223,2019-10-12,6,22
80,124,204,2019-10-12,6,23
52,58,110,2019-10-12,6,24
41,53,94,2019-10-13,7,1
28,36,64,2019-10-13,7,2
28,21,49,2019-10-13,7,3
19,24,43,2019-10-13,7,4
23,15,38,2019-10-13,7,5
44,34,78,2019-10-13,7,6
36,32,68,2019-10-13,7,7
45,41,86,2019-10-13,7,8
88,77,165,2019-10-13,7,9
184,145,329,2019-10-13,7,10
276,295,571,2019-10-13,7,11
344,335,679,2019-10-13,7,12
349,334,683,2019-10-13,7,13
367,399,766,2019-10-13,7,14
386,416,802,2019-10-13,7,15
331,336,667,2019-10-13,7,16
336,334,670,2019-10-13,7,17
336,343,679,2019-10-13,7,18
246,252,498,2019-10-13,7,19
165,186,351,2019-10-13,7,20
109,125,234,2019-10-13,7,21
61,110,171,2019-10-13,7,22
67,52,119,2019-10-13,7,23
18,42,60,2019-10-13,7,24
10,23,33,2019-10-14,1,1
7,14,21,2019-10-14,1,2
9,9,18,2019-10-14,1,3
10,9,19,2019-10-14,1,4
50,39,89,2019-10-14,1,5
200,172,372,2019-10-14,1,6
510,389,899,2019-10-14,1,7
619,400,1019,2019-10-14,1,8
498,391,889,2019-10-14,1,9
498,448,946,2019-10-14,1,10
576,520,1096,2019-10-14,1,11
540,575,1115,2019-10-14,1,12
513,503,1016,2019-10-14,1,13
473,498,971,2019-10-14,1,14
524,529,1053,2019-10-14,1,15
555,633,1188,2019-10-14,1,16
716,767,1483,2019-10-14,1,17
474,636,1110,2019-10-14,1,18
354,451,805,2019-10-14,1,19
256,273,529,2019-10-14,1,20
155,163,318,2019-10-14,1,21
121,119,240,2019-10-14,1,22
44,82,126,2019-10-14,1,23
26,26,52,2019-10-14,1,24
16,16,32,2019-10-15,2,1
4,2,6,2019-10-15,2,2
11,13,24,2019-10-15,2,3
8,26,34,2019-10-15,2,4
52,30,82,2019-10-15,2,5
207,136,343,2019-10-15,2,6
477,376,853,2019-10-15,2,7
653,426,1079,2019-10-15,2,8
514,434,948,2019-10-15,2,9
481,464,945,2019-10-15,2,10
560,560,1120,2019-10-15,2,11
583,537,1120,2019-10-15,2,12
633,621,1254,2019-10-15,2,13
611,584,1195,2019-10-15,2,14
631,592,1223,2019-10-15,2,15
731,731,1462,2019-10-15,2,16
790,798,1588,2019-10-15,2,17
540,670,1210,2019-10-15,2,18
413,478,891,2019-10-15,2,19
288,302,590,2019-10-15,2,20
164,203,367,2019-10-15,2,21
101,136,237,2019-10-15,2,22
51,72,123,2019-10-15,2,23
32,37,69,2019-10-15,2,24
24,20,44,2019-10-16,3,1
5,19,24,2019-10-16,3,2
9,15,24,2019-10-16,3,3
10,12,22,2019-10-16,3,4
49,30,79,2019-10-16,3,5
217,144,361,2019-10-16,3,6
471,364,835,2019-10-16,3,7
656,456,1112,2019-10-16,3,8
529,378,907,2019-10-16,3,9
482,448,930,2019-10-16,3,10
566,540,1106,2019-10-16,3,11
606,532,1138,2019-10-16,3,12
587,552,1139,2019-10-16,3,13
705,583,1288,2019-10-16,3,14
605,566,1171,2019-10-16,3,15
659,643,1302,2019-10-16,3,16
770,708,1478,2019-10-16,3,17
521,567,1088,2019-10-16,3,18
388,459,847,2019-10-16,3,19
238,252,490,2019-10-16,3,20
142,184,326,2019-10-16,3,21
99,133,232,2019-10-16,3,22
75,75,150,2019-10-16,3,23
29,44,73,2019-10-16,3,24
24,26,50,2019-10-17,4,1
9,13,22,2019-10-17,4,2
13,14,27,2019-10-17,4,3
13,11,24,2019-10-17,4,4
55,36,91,2019-10-17,4,5
185,149,334,2019-10-17,4,6
480,356,836,2019-10-17,4,7
629,412,1041,2019-10-17,4,8
496,401,897,2019-10-17,4,9
497,441,938,2019-10-17,4,10
505,529,1034,2019-10-17,4,11
540,570,1110,2019-10-17,4,12
551,589,1140,2019-10-17,4,13
486,564,1050,2019-10-17,4,14
568,609,1177,2019-10-17,4,15
618,651,1269,2019-10-17,4,16
728,747,1475,2019-10-17,4,17
508,602,1110,2019-10-17,4,18
377,512,889,2019-10-17,4,19
259,342,601,2019-10-17,4,20
146,159,305,2019-10-17,4,21
115,151,266,2019-10-17,4,22
118,84,202,2019-10-17,4,23
58,50,108,2019-10-17,4,24
22,16,38,2019-10-18,5,1
11,23,34,2019-10-18,5,2
12,14,26,2019-10-18,5,3
9,15,24,2019-10-18,5,4
48,32,80,2019-10-18,5,5
196,135,331,2019-10-18,5,6
452,344,796,2019-10-18,5,7
548,377,925,2019-10-18,5,8
507,395,902,2019-10-18,5,9
523,441,964,2019-10-18,5,10
566,536,1102,2019-10-18,5,11
620,611,1231,2019-10-18,5,12
589,714,1303,2019-10-18,5,13
623,608,1231,2019-10-18,5,14
618,655,1273,2019-10-18,5,15
573,585,1158,2019-10-18,5,16
570,580,1150,2019-10-18,5,17
468,483,951,2019-10-18,5,18
365,432,797,2019-10-18,5,19
225,314,539,2019-10-18,5,20
145,198,343,2019-10-18,5,21
123,154,277,2019-10-18,5,22
103,111,214,2019-10-18,5,23
48,58,106,2019-10-18,5,24
24,38,62,2019-10-19,6,1
27,31,58,2019-10-19,6,2
23,22,45,2019-10-19,6,3
18,25,43,2019-10-19,6,4
30,27,57,2019-10-19,6,5
73,58,131,2019-10-19,6,6
72,94,166,2019-10-19,6,7
136,96,232,2019-10-19,6,8
261,175,436,2019-10-19,6,9
414,351,765,2019-10-19,6,10
477,476,953,2019-10-19,6,11
541,531,1072,2019-10-19,6,12
561,567,1128,2019-10-19,6,13
488,524,1012,2019-10-19,6,14
524,497,1021,2019-10-19,6,15
415,437,852,2019-10-19,6,16
379,414,793,2019-10-19,6,17
356,396,752,2019-10-19,6,18
320,312,632,2019-10-19,6,19
218,244,462,2019-10-19,6,20
136,149,285,2019-10-19,6,21
102,121,223,2019-10-19,6,22
121,123,244,2019-10-19,6,23
71,104,175,2019-10-19,6,24
44,67,111,2019-10-20,7,1
49,36,85,2019-10-20,7,2
29,30,59,2019-10-20,7,3
15,23,38,2019-10-20,7,4
21,20,41,2019-10-20,7,5
52,49,101,2019-10-20,7,6
32,51,83,2019-10-20,7,7
53,63,116,2019-10-20,7,8
124,107,231,2019-10-20,7,9
190,193,383,2019-10-20,7,10
309,323,632,2019-10-20,7,11
378,346,724,2019-10-20,7,12
442,398,840,2019-10-20,7,13
439,412,851,2019-10-20,7,14
434,412,846,2019-10-20,7,15
373,462,835,2019-10-20,7,16
355,485,840,2019-10-20,7,17
368,427,795,2019-10-20,7,18
279,250,529,2019-10-20,7,19
175,179,354,2019-10-20,7,20
140,129,269,2019-10-20,7,21
68,90,158,2019-10-20,7,22
52,47,99,2019-10-20,7,23
20,24,44,2019-10-20,7,24
16,19,35,2019-10-21,1,1
6,16,22,2019-10-21,1,2
9,15,24,2019-10-21,1,3
10,16,26,2019-10-21,1,4
55,44,99,2019-10-21,1,5
213,162,375,2019-10-21,1,6
573,418,991,2019-10-21,1,7
812,507,1319,2019-10-21,1,8
558,441,999,2019-10-21,1,9
504,455,959,2019-10-21,1,10
514,519,1033,2019-10-21,1,11
499,550,1049,2019-10-21,1,12
516,545,1061,2019-10-21,1,13
509,582,1091,2019-10-21,1,14
523,561,1084,2019-10-21,1,15
630,717,1347,2019-10-21,1,16
686,722,1408,2019-10-21,1,17
487,595,1082,2019-10-21,1,18
332,495,827,2019-10-21,1,19
232,276,508,2019-10-21,1,20
137,147,284,2019-10-21,1,21
93,104,197,2019-10-21,1,22
44,65,109,2019-10-21,1,23
23,29,52,2019-10-21,1,24
9,15,24,2019-10-22,2,1
4,10,14,2019-10-22,2,2
6,9,15,2019-10-22,2,3
7,9,16,2019-10-22,2,4
51,39,90,2019-10-22,2,5
203,162,365,2019-10-22,2,6
561,418,979,2019-10-22,2,7
802,551,1353,2019-10-22,2,8
521,432,953,2019-10-22,2,9
504,454,958,2019-10-22,2,10
478,461,939,2019-10-22,2,11
448,532,980,2019-10-22,2,12
500,579,1079,2019-10-22,2,13
461,604,1065,2019-10-22,2,14
493,569,1062,2019-10-22,2,15
606,705,1311,2019-10-22,2,16
741,808,1549,2019-10-22,2,17
474,654,1128,2019-10-22,2,18
396,528,924,2019-10-22,2,19
247,341,588,2019-10-22,2,20
136,211,347,2019-10-22,2,21
107,145,252,2019-10-22,2,22
52,86,138,2019-10-22,2,23
33,36,69,2019-10-22,2,24
10,16,26,2019-10-23,3,1
7,8,15,2019-10-23,3,2
9,9,18,2019-10-23,3,3
8,13,21,2019-10-23,3,4
48,34,82,2019-10-23,3,5
199,158,357,2019-10-23,3,6
519,391,910,2019-10-23,3,7
836,527,1363,2019-10-23,3,8
568,386,954,2019-10-23,3,9
497,439,936,2019-10-23,3,10
483,496,979,2019-10-23,3,11
484,493,977,2019-10-23,3,12
540,566,1106,2019-10-23,3,13
512,601,1113,2019-10-23,3,14
497,600,1097,2019-10-23,3,15
578,748,1326,2019-10-23,3,16
715,738,1453,2019-10-23,3,17
488,594,1082,2019-10-23,3,18
414,515,929,2019-10-23,3,19
235,263,498,2019-10-23,3,20
142,163,305,2019-10-23,3,21
96,140,236,2019-10-23,3,22
67,82,149,2019-10-23,3,23
39,29,68,2019-10-23,3,24
16,18,34,2019-10-24,4,1
5,8,13,2019-10-24,4,2
4,9,13,2019-10-24,4,3
9,10,19,2019-10-24,4,4
54,33,87,2019-10-24,4,5
193,139,332,2019-10-24,4,6
529,388,917,2019-10-24,4,7
856,538,1394,2019-10-24,4,8
559,434,993,2019-10-24,4,9
472,435,907,2019-10-24,4,10
476,484,960,2019-10-24,4,11
536,525,1061,2019-10-24,4,12
505,573,1078,2019-10-24,4,13
550,608,1158,2019-10-24,4,14
549,610,1159,2019-10-24,4,15
621,662,1283,2019-10-24,4,16
751,786,1537,2019-10-24,4,17
523,638,1161,2019-10-24,4,18
403,512,915,2019-10-24,4,19
237,298,535,2019-10-24,4,20
164,210,374,2019-10-24,4,21
122,148,270,2019-10-24,4,22
71,93,164,2019-10-24,4,23
29,41,70,2019-10-24,4,24
15,15,30,2019-10-25,5,1
8,18,26,2019-10-25,5,2
4,3,7,2019-10-25,5,3
5,15,20,2019-10-25,5,4
44,30,74,2019-10-25,5,5
184,150,334,2019-10-25,5,6
514,384,898,2019-10-25,5,7
740,496,1236,2019-10-25,5,8
492,434,926,2019-10-25,5,9
488,458,946,2019-10-25,5,10
553,481,1034,2019-10-25,5,11
619,609,1228,2019-10-25,5,12
630,670,1300,2019-10-25,5,13
580,763,1343,2019-10-25,5,14
627,700,1327,2019-10-25,5,15
626,696,1322,2019-10-25,5,16
567,589,1156,2019-10-25,5,17
528,555,1083,2019-10-25,5,18
334,421,755,2019-10-25,5,19
236,291,527,2019-10-25,5,20
131,171,302,2019-10-25,5,21
138,208,346,2019-10-25,5,22
85,96,181,2019-10-25,5,23
65,75,140,2019-10-25,5,24
38,54,92,2019-10-26,6,1
28,35,63,2019-10-26,6,2
21,23,44,2019-10-26,6,3
9,14,23,2019-10-26,6,4
23,17,40,2019-10-26,6,5
61,51,112,2019-10-26,6,6
82,71,153,2019-10-26,6,7
138,115,253,2019-10-26,6,8
262,206,468,2019-10-26,6,9
360,329,689,2019-10-26,6,10
518,453,971,2019-10-26,6,11
530,492,1022,2019-10-26,6,12
480,443,923,2019-10-26,6,13
441,500,941,2019-10-26,6,14
463,429,892,2019-10-26,6,15
365,441,806,2019-10-26,6,16
327,385,712,2019-10-26,6,17
391,385,776,2019-10-26,6,18
308,326,634,2019-10-26,6,19
198,232,430,2019-10-26,6,20
128,180,308,2019-10-26,6,21
103,135,238,2019-10-26,6,22
76,89,165,2019-10-26,6,23
53,90,143,2019-10-26,6,24
38,63,101,2019-10-27,7,1
27,27,54,2019-10-27,7,2
18,20,38,2019-10-27,7,3
16,17,33,2019-10-27,7,4
13,7,20,2019-10-27,7,5
46,29,75,2019-10-27,7,6
30,37,67,2019-10-27,7,7
54,51,105,2019-10-27,7,8
117,91,208,2019-10-27,7,9
226,223,449,2019-10-27,7,10
355,319,674,2019-10-27,7,11
373,340,713,2019-10-27,7,12
459,384,843,2019-10-27,7,13
412,424,836,2019-10-27,7,14
370,446,816,2019-10-27,7,15
356,387,743,2019-10-27,7,16
349,405,754,2019-10-27,7,17
356,376,732,2019-10-27,7,18
220,219,439,2019-10-27,7,19
152,204,356,2019-10-27,7,20
114,120,234,2019-10-27,7,21
62,87,149,2019-10-27,7,22
38,61,99,2019-10-27,7,23
17,15,32,2019-10-27,7,24
11,12,23,2019-10-28,1,1
2,10,12,2019-10-28,1,2
9,12,21,2019-10-28,1,3
10,20,30,2019-10-28,1,4
55,35,90,2019-10-28,1,5
207,157,364,2019-10-28,1,6
568,389,957,2019-10-28,1,7
848,582,1430,2019-10-28,1,8
535,449,984,2019-10-28,1,9
501,490,991,2019-10-28,1,10
512,514,1026,2019-10-28,1,11
476,545,1021,2019-10-28,1,12
511,549,1060,2019-10-28,1,13
499,581,1080,2019-10-28,1,14
528,573,1101,2019-10-28,1,15
581,694,1275,2019-10-28,1,16
697,802,1499,2019-10-28,1,17
529,627,1156,2019-10-28,1,18
330,451,781,2019-10-28,1,19
226,222,448,2019-10-28,1,20
129,157,286,2019-10-28,1,21
92,132,224,2019-10-28,1,22
42,53,95,2019-10-28,1,23
23,30,53,2019-10-28,1,24
13,15,28,2019-10-29,2,1
7,7,14,2019-10-29,2,2
7,11,18,2019-10-29,2,3
13,13,26,2019-10-29,2,4
39,35,74,2019-10-29,2,5
181,146,327,2019-10-29,2,6
548,398,946,2019-10-29,2,7
845,579,1424,2019-10-29,2,8
564,466,1030,2019-10-29,2,9
513,451,964,2019-10-29,2,10
516,526,1042,2019-10-29,2,11
527,559,1086,2019-10-29,2,12
493,609,1102,2019-10-29,2,13
543,673,1216,2019-10-29,2,14
566,592,1158,2019-10-29,2,15
561,718,1279,2019-10-29,2,16
735,797,1532,2019-10-29,2,17
552,636,1188,2019-10-29,2,18
404,452,856,2019-10-29,2,19
232,290,522,2019-10-29,2,20
139,185,324,2019-10-29,2,21
109,157,266,2019-10-29,2,22
59,80,139,2019-10-29,2,23
25,38,63,2019-10-29,2,24
17,23,40,2019-10-30,3,1
7,10,17,2019-10-30,3,2
4,9,13,2019-10-30,3,3
11,13,24,2019-10-30,3,4
45,41,86,2019-10-30,3,5
172,135,307,2019-10-30,3,6
536,368,904,2019-10-30,3,7
814,545,1359,2019-10-30,3,8
609,451,1060,2019-10-30,3,9
533,474,1007,2019-10-30,3,10
501,537,1038,2019-10-30,3,11
559,548,1107,2019-10-30,3,12
541,625,1166,2019-10-30,3,13
527,718,1245,2019-10-30,3,14
584,705,1289,2019-10-30,3,15
619,755,1374,2019-10-30,3,16
677,744,1421,2019-10-30,3,17
581,639,1220,2019-10-30,3,18
391,508,899,2019-10-30,3,19
255,298,553,2019-10-30,3,20
162,180,342,2019-10-30,3,21
112,143,255,2019-10-30,3,22
89,101,190,2019-10-30,3,23
58,72,130,2019-10-30,3,24
49,54,103,2019-10-31,4,1
35,44,79,2019-10-31,4,2
23,34,57,2019-10-31,4,3
20,26,46,2019-10-31,4,4
24,28,52,2019-10-31,4,5
50,42,92,2019-10-31,4,6
54,44,98,2019-10-31,4,7
61,52,113,2019-10-31,4,8
116,98,214,2019-10-31,4,9
214,206,420,2019-10-31,4,10
309,283,592,2019-10-31,4,11
379,355,734,2019-10-31,4,12
432,370,802,2019-10-31,4,13
437,404,841,2019-10-31,4,14
456,441,897,2019-10-31,4,15
392,439,831,2019-10-31,4,16
374,439,813,2019-10-31,4,17
367,434,801,2019-10-31,4,18
302,324,626,2019-10-31,4,19
209,227,436,2019-10-31,4,20
141,155,296,2019-10-31,4,21
82,99,181,2019-10-31,4,22
49,64,113,2019-10-31,4,23
26,38,64,2019-10-31,4,24
10,26,36,2019-11-01,5,1
10,8,18,2019-11-01,5,2
11,14,25,2019-11-01,5,3
16,25,41,2019-11-01,5,4
13,18,31,2019-11-01,5,5
116,85,201,2019-11-01,5,6
295,188,483,2019-11-01,5,7
475,369,844,2019-11-01,5,8
457,379,836,2019-11-01,5,9
534,493,1027,2019-11-01,5,10
578,527,1105,2019-11-01,5,11
555,603,1158,2019-11-01,5,12
539,594,1133,2019-11-01,5,13
548,661,1209,2019-11-01,5,14
594,595,1189,2019-11-01,5,15
517,585,1102,2019-11-01,5,16
474,543,1017,2019-11-01,5,17
423,406,829,2019-11-01,5,18
271,314,585,2019-11-01,5,19
229,211,440,2019-11-01,5,20
131,164,295,2019-11-01,5,21
88,111,199,2019-11-01,5,22
88,98,186,2019-11-01,5,23
42,62,104,2019-11-01,5,24
41,47,88,2019-11-02,6,1
24,32,56,2019-11-02,6,2
9,12,21,2019-11-02,6,3
6,15,21,2019-11-02,6,4
21,23,44,2019-11-02,6,5
67,52,119,2019-11-02,6,6
65,58,123,2019-11-02,6,7
112,85,197,2019-11-02,6,8
247,228,475,2019-11-02,6,9
435,320,755,2019-11-02,6,10
438,399,837,2019-11-02,6,11
487,455,942,2019-11-02,6,12
441,442,883,2019-11-02,6,13
467,484,951,2019-11-02,6,14
402,503,905,2019-11-02,6,15
336,364,700,2019-11-02,6,16
369,394,763,2019-11-02,6,17
335,362,697,2019-11-02,6,18
282,315,597,2019-11-02,6,19
154,166,320,2019-11-02,6,20
106,154,260,2019-11-02,6,21
84,120,204,2019-11-02,6,22
81,125,206,2019-11-02,6,23
44,82,126,2019-11-02,6,24
40,63,103,2019-11-03,7,1
36,15,51,2019-11-03,7,2
21,24,45,2019-11-03,7,3
15,27,42,2019-11-03,7,4
15,18,33,2019-11-03,7,5
41,34,75,2019-11-03,7,6
41,44,85,2019-11-03,7,7
46,60,106,2019-11-03,7,8
129,95,224,2019-11-03,7,9
257,223,480,2019-11-03,7,10
376,320,696,2019-11-03,7,11
455,331,786,2019-11-03,7,12
510,404,914,2019-11-03,7,13
570,481,1051,2019-11-03,7,14
483,472,955,2019-11-03,7,15
424,502,926,2019-11-03,7,16
378,499,877,2019-11-03,7,17
316,389,705,2019-11-03,7,18
168,197,365,2019-11-03,7,19
134,170,304,2019-11-03,7,20
117,145,262,2019-11-03,7,21
64,90,154,2019-11-03,7,22
48,57,105,2019-11-03,7,23
17,24,41,2019-11-03,7,24
11,22,33,2019-11-04,1,1
5,10,15,2019-11-04,1,2
6,11,17,2019-11-04,1,3
10,12,22,2019-11-04,1,4
43,40,83,2019-11-04,1,5
228,175,403,2019-11-04,1,6
544,447,991,2019-11-04,1,7
854,538,1392,2019-11-04,1,8
566,469,1035,2019-11-04,1,9
507,439,946,2019-11-04,1,10
501,468,969,2019-11-04,1,11
461,471,932,2019-11-04,1,12
469,516,985,2019-11-04,1,13
505,542,1047,2019-11-04,1,14
527,489,1016,2019-11-04,1,15
493,655,1148,2019-11-04,1,16
707,626,1333,2019-11-04,1,17
538,604,1142,2019-11-04,1,18
339,431,770,2019-11-04,1,19
220,284,504,2019-11-04,1,20
126,166,292,2019-11-04,1,21
106,123,229,2019-11-04,1,22
46,83,129,2019-11-04,1,23
23,18,41,2019-11-04,1,24
9,9,18,2019-11-05,2,1
4,6,10,2019-11-05,2,2
9,14,23,2019-11-05,2,3
12,16,28,2019-11-05,2,4
32,35,67,2019-11-05,2,5
194,146,340,2019-11-05,2,6
566,429,995,2019-11-05,2,7
754,432,1186,2019-11-05,2,8
598,435,1033,2019-11-05,2,9
483,414,897,2019-11-05,2,10
487,460,947,2019-11-05,2,11
487,488,975,2019-11-05,2,12
519,547,1066,2019-11-05,2,13
440,565,1005,2019-11-05,2,14
528,533,1061,2019-11-05,2,15
532,645,1177,2019-11-05,2,16
708,673,1381,2019-11-05,2,17
516,614,1130,2019-11-05,2,18
313,468,781,2019-11-05,2,19
238,243,481,2019-11-05,2,20
134,162,296,2019-11-05,2,21
94,130,224,2019-11-05,2,22
64,71,135,2019-11-05,2,23
40,36,76,2019-11-05,2,24
10,13,23,2019-11-06,3,1
7,6,13,2019-11-06,3,2
7,14,21,2019-11-06,3,3
8,11,19,2019-11-06,3,4
42,44,86,2019-11-06,3,5
200,156,356,2019-11-06,3,6
568,397,965,2019-11-06,3,7
866,516,1382,2019-11-06,3,8
543,426,969,2019-11-06,3,9
485,366,851,2019-11-06,3,10
486,434,920,2019-11-06,3,11
433,475,908,2019-11-06,3,12
523,591,1114,2019-11-06,3,13
503,553,1056,2019-11-06,3,14
498,547,1045,2019-11-06,3,15
613,637,1250,2019-11-06,3,16
619,755,1374,2019-11-06,3,17
556,608,1164,2019-11-06,3,18
344,432,776,2019-11-06,3,19
215,266,481,2019-11-06,3,20
130,157,287,2019-11-06,3,21
118,125,243,2019-11-06,3,22
63,74,137,2019-11-06,3,23
25,32,57,2019-11-06,3,24
19,13,32,2019-11-07,4,1
7,8,15,2019-11-07,4,2
7,12,19,2019-11-07,4,3
12,12,24,2019-11-07,4,4
36,38,74,2019-11-07,4,5
193,149,342,2019-11-07,4,6
555,374,929,2019-11-07,4,7
830,571,1401,2019-11-07,4,8
588,417,1005,2019-11-07,4,9
496,451,947,2019-11-07,4,10
486,444,930,2019-11-07,4,11
462,514,976,2019-11-07,4,12
464,481,945,2019-11-07,4,13
521,533,1054,2019-11-07,4,14
549,513,1062,2019-11-07,4,15
607,638,1245,2019-11-07,4,16
696,681,1377,2019-11-07,4,17
523,595,1118,2019-11-07,4,18
457,473,930,2019-11-07,4,19
244,279,523,2019-11-07,4,20
135,189,324,2019-11-07,4,21
112,254,366,2019-11-07,4,22
78,102,180,2019-11-07,4,23
33,52,85,2019-11-07,4,24
14,18,32,2019-11-08,5,1
6,8,14,2019-11-08,5,2
7,12,19,2019-11-08,5,3
7,18,25,2019-11-08,5,4
36,33,69,2019-11-08,5,5
197,147,344,2019-11-08,5,6
534,381,915,2019-11-08,5,7
824,537,1361,2019-11-08,5,8
537,423,960,2019-11-08,5,9
551,448,999,2019-11-08,5,10
518,526,1044,2019-11-08,5,11
601,561,1162,2019-11-08,5,12
648,616,1264,2019-11-08,5,13
617,730,1347,2019-11-08,5,14
660,720,1380,2019-11-08,5,15
584,589,1173,2019-11-08,5,16
568,666,1234,2019-11-08,5,17
411,499,910,2019-11-08,5,18
300,396,696,2019-11-08,5,19
232,258,490,2019-11-08,5,20
140,160,300,2019-11-08,5,21
101,139,240,2019-11-08,5,22
65,135,200,2019-11-08,5,23
63,64,127,2019-11-08,5,24
28,40,68,2019-11-09,6,1
24,24,48,2019-11-09,6,2
14,12,26,2019-11-09,6,3
21,20,41,2019-11-09,6,4
21,22,43,2019-11-09,6,5
75,61,136,2019-11-09,6,6
80,61,141,2019-11-09,6,7
141,121,262,2019-11-09,6,8
261,205,466,2019-11-09,6,9
455,334,789,2019-11-09,6,10
599,469,1068,2019-11-09,6,11
633,503,1136,2019-11-09,6,12
477,505,982,2019-11-09,6,13
463,468,931,2019-11-09,6,14
443,475,918,2019-11-09,6,15
393,492,885,2019-11-09,6,16
408,501,909,2019-11-09,6,17
392,460,852,2019-11-09,6,18
275,302,577,2019-11-09,6,19
179,194,373,2019-11-09,6,20
135,182,317,2019-11-09,6,21
129,131,260,2019-11-09,6,22
91,118,209,2019-11-09,6,23
60,104,164,2019-11-09,6,24
47,51,98,2019-11-10,7,1
33,32,65,2019-11-10,7,2
25,31,56,2019-11-10,7,3
20,27,47,2019-11-10,7,4
19,16,35,2019-11-10,7,5
53,37,90,2019-11-10,7,6
51,35,86,2019-11-10,7,7
35,48,83,2019-11-10,7,8
114,73,187,2019-11-10,7,9
227,186,413,2019-11-10,7,10
262,319,581,2019-11-10,7,11
381,360,741,2019-11-10,7,12
502,378,880,2019-11-10,7,13
473,452,925,2019-11-10,7,14
429,495,924,2019-11-10,7,15
368,477,845,2019-11-10,7,16
405,432,837,2019-11-10,7,17
320,355,675,2019-11-10,7,18
230,228,458,2019-11-10,7,19
156,178,334,2019-11-10,7,20
109,126,235,2019-11-10,7,21
72,84,156,2019-11-10,7,22
52,48,100,2019-11-10,7,23
25,27,52,2019-11-10,7,24
9,24,33,2019-11-11,1,1
11,22,33,2019-11-11,1,2
6,9,15,2019-11-11,1,3
11,14,25,2019-11-11,1,4
47,43,90,2019-11-11,1,5
222,162,384,2019-11-11,1,6
603,446,1049,2019-11-11,1,7
837,545,1382,2019-11-11,1,8
595,457,1052,2019-11-11,1,9
535,470,1005,2019-11-11,1,10
535,512,1047,2019-11-11,1,11
518,537,1055,2019-11-11,1,12
512,572,1084,2019-11-11,1,13
493,616,1109,2019-11-11,1,14
582,575,1157,2019-11-11,1,15
609,790,1399,2019-11-11,1,16
748,791,1539,2019-11-11,1,17
534,671,1205,2019-11-11,1,18
338,561,899,2019-11-11,1,19
278,283,561,2019-11-11,1,20
164,157,321,2019-11-11,1,21
123,139,262,2019-11-11,1,22
57,62,119,2019-11-11,1,23
20,22,42,2019-11-11,1,24
11,16,27,2019-11-12,2,1
6,8,14,2019-11-12,2,2
12,8,20,2019-11-12,2,3
7,12,19,2019-11-12,2,4
37,36,73,2019-11-12,2,5
221,150,371,2019-11-12,2,6
594,449,1043,2019-11-12,2,7
836,554,1390,2019-11-12,2,8
560,439,999,2019-11-12,2,9
482,447,929,2019-11-12,2,10
473,507,980,2019-11-12,2,11
492,480,972,2019-11-12,2,12
463,520,983,2019-11-12,2,13
517,585,1102,2019-11-12,2,14
568,582,1150,2019-11-12,2,15
599,724,1323,2019-11-12,2,16
707,753,1460,2019-11-12,2,17
511,633,1144,2019-11-12,2,18
357,456,813,2019-11-12,2,19
207,271,478,2019-11-12,2,20
136,186,322,2019-11-12,2,21
105,137,242,2019-11-12,2,22
45,83,128,2019-11-12,2,23
30,29,59,2019-11-12,2,24
11,15,26,2019-11-13,3,1
12,16,28,2019-11-13,3,2
6,6,12,2019-11-13,3,3
8,9,17,2019-11-13,3,4
34,31,65,2019-11-13,3,5
217,151,368,2019-11-13,3,6
533,386,919,2019-11-13,3,7
822,536,1358,2019-11-13,3,8
607,429,1036,2019-11-13,3,9
562,437,999,2019-11-13,3,10
438,510,948,2019-11-13,3,11
514,517,1031,2019-11-13,3,12
470,582,1052,2019-11-13,3,13
527,608,1135,2019-11-13,3,14
533,588,1121,2019-11-13,3,15
587,708,1295,2019-11-13,3,16
664,806,1470,2019-11-13,3,17
473,573,1046,2019-11-13,3,18
359,469,828,2019-11-13,3,19
235,253,488,2019-11-13,3,20
158,179,337,2019-11-13,3,21
116,128,244,2019-11-13,3,22
76,93,169,2019-11-13,3,23
27,57,84,2019-11-13,3,24
20,21,41,2019-11-14,4,1
2,11,13,2019-11-14,4,2
13,13,26,2019-11-14,4,3
10,11,21,2019-11-14,4,4
46,33,79,2019-11-14,4,5
217,147,364,2019-11-14,4,6
521,407,928,2019-11-14,4,7
860,552,1412,2019-11-14,4,8
576,439,1015,2019-11-14,4,9
536,473,1009,2019-11-14,4,10
533,503,1036,2019-11-14,4,11
478,529,1007,2019-11-14,4,12
529,569,1098,2019-11-14,4,13
530,590,1120,2019-11-14,4,14
533,543,1076,2019-11-14,4,15
630,664,1294,2019-11-14,4,16
705,716,1421,2019-11-14,4,17
518,585,1103,2019-11-14,4,18
347,489,836,2019-11-14,4,19
253,293,546,2019-11-14,4,20
142,207,349,2019-11-14,4,21
135,131,266,2019-11-14,4,22
82,92,174,2019-11-14,4,23
31,61,92,2019-11-14,4,24
11,24,35,2019-11-15,5,1
10,8,18,2019-11-15,5,2
12,8,20,2019-11-15,5,3
4,10,14,2019-11-15,5,4
39,29,68,2019-11-15,5,5
224,150,374,2019-11-15,5,6
504,398,902,2019-11-15,5,7
794,526,1320,2019-11-15,5,8
518,427,945,2019-11-15,5,9
483,456,939,2019-11-15,5,10
520,462,982,2019-11-15,5,11
647,591,1238,2019-11-15,5,12
631,717,1348,2019-11-15,5,13
566,700,1266,2019-11-15,5,14
600,713,1313,2019-11-15,5,15
553,654,1207,2019-11-15,5,16
562,570,1132,2019-11-15,5,17
406,467,873,2019-11-15,5,18
349,372,721,2019-11-15,5,19
272,269,541,2019-11-15,5,20
149,187,336,2019-11-15,5,21
101,134,235,2019-11-15,5,22
99,127,226,2019-11-15,5,23
56,90,146,2019-11-15,5,24
42,42,84,2019-11-16,6,1
23,28,51,2019-11-16,6,2
20,12,32,2019-11-16,6,3
8,14,22,2019-11-16,6,4
19,23,42,2019-11-16,6,5
70,55,125,2019-11-16,6,6
58,57,115,2019-11-16,6,7
120,102,222,2019-11-16,6,8
247,195,442,2019-11-16,6,9
351,296,647,2019-11-16,6,10
471,398,869,2019-11-16,6,11
474,471,945,2019-11-16,6,12
479,458,937,2019-11-16,6,13
405,483,888,2019-11-16,6,14
365,417,782,2019-11-16,6,15
345,377,722,2019-11-16,6,16
328,343,671,2019-11-16,6,17
312,329,641,2019-11-16,6,18
259,311,570,2019-11-16,6,19
192,180,372,2019-11-16,6,20
148,159,307,2019-11-16,6,21
125,94,219,2019-11-16,6,22
84,102,186,2019-11-16,6,23
58,95,153,2019-11-16,6,24
33,74,107,2019-11-17,7,1
31,37,68,2019-11-17,7,2
21,31,52,2019-11-17,7,3
16,20,36,2019-11-17,7,4
21,23,44,2019-11-17,7,5
44,44,88,2019-11-17,7,6
37,42,79,2019-11-17,7,7
34,47,81,2019-11-17,7,8
99,80,179,2019-11-17,7,9
171,191,362,2019-11-17,7,10
255,286,541,2019-11-17,7,11
328,347,675,2019-11-17,7,12
457,332,789,2019-11-17,7,13
421,366,787,2019-11-17,7,14
420,439,859,2019-11-17,7,15
377,448,825,2019-11-17,7,16
376,389,765,2019-11-17,7,17
296,318,614,2019-11-17,7,18
204,226,430,2019-11-17,7,19
194,166,360,2019-11-17,7,20
121,132,253,2019-11-17,7,21
80,97,177,2019-11-17,7,22
48,58,106,2019-11-17,7,23
26,25,51,2019-11-17,7,24
11,19,30,2019-11-18,1,1
6,11,17,2019-11-18,1,2
5,5,10,2019-11-18,1,3
11,15,26,2019-11-18,1,4
49,38,87,2019-11-18,1,5
190,151,341,2019-11-18,1,6
549,428,977,2019-11-18,1,7
865,575,1440,2019-11-18,1,8
508,445,953,2019-11-18,1,9
512,457,969,2019-11-18,1,10
494,467,961,2019-11-18,1,11
469,515,984,2019-11-18,1,12
481,520,1001,2019-11-18,1,13
459,594,1053,2019-11-18,1,14
501,569,1070,2019-11-18,1,15
587,648,1235,2019-11-18,1,16
698,749,1447,2019-11-18,1,17
579,619,1198,2019-11-18,1,18
333,442,775,2019-11-18,1,19
243,267,510,2019-11-18,1,20
149,152,301,2019-11-18,1,21
97,130,227,2019-11-18,1,22
53,92,145,2019-11-18,1,23
22,31,53,2019-11-18,1,24
11,9,20,2019-11-19,2,1
5,10,15,2019-11-19,2,2
11,9,20,2019-11-19,2,3
7,10,17,2019-11-19,2,4
34,33,67,2019-11-19,2,5
198,148,346,2019-11-19,2,6
319,268,587,2019-11-19,2,7
794,563,1357,2019-11-19,2,8
489,406,895,2019-11-19,2,9
467,406,873,2019-11-19,2,10
443,443,886,2019-11-19,2,11
441,460,901,2019-11-19,2,12
459,488,947,2019-11-19,2,13
467,525,992,2019-11-19,2,14
556,577,1133,2019-11-19,2,15
592,645,1237,2019-11-19,2,16
671,720,1391,2019-11-19,2,17
530,621,1151,2019-11-19,2,18
358,419,777,2019-11-19,2,19
220,268,488,2019-11-19,2,20
134,172,306,2019-11-19,2,21
101,123,224,2019-11-19,2,22
65,79,144,2019-11-19,2,23
24,42,66,2019-11-19,2,24
17,23,40,2019-11-20,3,1
4,14,18,2019-11-20,3,2
5,5,10,2019-11-20,3,3
7,8,15,2019-11-20,3,4
38,33,71,2019-11-20,3,5
202,137,339,2019-11-20,3,6
489,385,874,2019-11-20,3,7
788,572,1360,2019-11-20,3,8
597,454,1051,2019-11-20,3,9
509,437,946,2019-11-20,3,10
475,478,953,2019-11-20,3,11
480,479,959,2019-11-20,3,12
452,576,1028,2019-11-20,3,13
485,556,1041,2019-11-20,3,14
517,592,1109,2019-11-20,3,15
565,707,1272,2019-11-20,3,16
649,748,1397,2019-11-20,3,17
480,585,1065,2019-11-20,3,18
362,407,769,2019-11-20,3,19
214,217,431,2019-11-20,3,20
155,181,336,2019-11-20,3,21
105,138,243,2019-11-20,3,22
74,91,165,2019-11-20,3,23
30,30,60,2019-11-20,3,24
22,9,31,2019-11-21,4,1
10,19,29,2019-11-21,4,2
9,13,22,2019-11-21,4,3
10,7,17,2019-11-21,4,4
35,40,75,2019-11-21,4,5
193,139,332,2019-11-21,4,6
501,396,897,2019-11-21,4,7
832,599,1431,2019-11-21,4,8
571,427,998,2019-11-21,4,9
494,434,928,2019-11-21,4,10
493,486,979,2019-11-21,4,11
438,520,958,2019-11-21,4,12
493,528,1021,2019-11-21,4,13
499,555,1054,2019-11-21,4,14
536,531,1067,2019-11-21,4,15
580,646,1226,2019-11-21,4,16
721,723,1444,2019-11-21,4,17
506,597,1103,2019-11-21,4,18
330,470,800,2019-11-21,4,19
237,295,532,2019-11-21,4,20
144,156,300,2019-11-21,4,21
122,146,268,2019-11-21,4,22
76,76,152,2019-11-21,4,23
41,40,81,2019-11-21,4,24
15,15,30,2019-11-22,5,1
10,9,19,2019-11-22,5,2
7,8,15,2019-11-22,5,3
7,15,22,2019-11-22,5,4
35,33,68,2019-11-22,5,5
203,140,343,2019-11-22,5,6
512,390,902,2019-11-22,5,7
767,523,1290,2019-11-22,5,8
561,449,1010,2019-11-22,5,9
453,435,888,2019-11-22,5,10
551,484,1035,2019-11-22,5,11
577,546,1123,2019-11-22,5,12
614,699,1313,2019-11-22,5,13
595,707,1302,2019-11-22,5,14
597,671,1268,2019-11-22,5,15
552,612,1164,2019-11-22,5,16
548,570,1118,2019-11-22,5,17
424,480,904,2019-11-22,5,18
321,371,692,2019-11-22,5,19
254,281,535,2019-11-22,5,20
129,178,307,2019-11-22,5,21
114,158,272,2019-11-22,5,22
90,167,257,2019-11-22,5,23
50,72,122,2019-11-22,5,24
26,49,75,2019-11-23,6,1
20,26,46,2019-11-23,6,2
6,13,19,2019-11-23,6,3
11,16,27,2019-11-23,6,4
21,24,45,2019-11-23,6,5
65,48,113,2019-11-23,6,6
73,63,136,2019-11-23,6,7
126,101,227,2019-11-23,6,8
253,204,457,2019-11-23,6,9
400,295,695,2019-11-23,6,10
517,438,955,2019-11-23,6,11
478,478,956,2019-11-23,6,12
500,483,983,2019-11-23,6,13
412,492,904,2019-11-23,6,14
402,491,893,2019-11-23,6,15
394,409,803,2019-11-23,6,16
394,425,819,2019-11-23,6,17
378,382,760,2019-11-23,6,18
272,354,626,2019-11-23,6,19
193,207,400,2019-11-23,6,20
126,180,306,2019-11-23,6,21
123,145,268,2019-11-23,6,22
108,98,206,2019-11-23,6,23
83,88,171,2019-11-23,6,24
52,46,98,2019-11-24,7,1
47,48,95,2019-11-24,7,2
30,33,63,2019-11-24,7,3
24,16,40,2019-11-24,7,4
24,21,45,2019-11-24,7,5
44,30,74,2019-11-24,7,6
40,49,89,2019-11-24,7,7
30,38,68,2019-11-24,7,8
88,98,186,2019-11-24,7,9
184,166,350,2019-11-24,7,10
263,295,558,2019-11-24,7,11
305,335,640,2019-11-24,7,12
379,330,709,2019-11-24,7,13
336,348,684,2019-11-24,7,14
417,374,791,2019-11-24,7,15
334,386,720,2019-11-24,7,16
338,333,671,2019-11-24,7,17
304,274,578,2019-11-24,7,18
209,247,456,2019-11-24,7,19
184,168,352,2019-11-24,7,20
105,128,233,2019-11-24,7,21
48,83,131,2019-11-24,7,22
52,68,120,2019-11-24,7,23
23,30,53,2019-11-24,7,24
11,20,31,2019-11-25,1,1
5,5,10,2019-11-25,1,2
4,8,12,2019-11-25,1,3
7,19,26,2019-11-25,1,4
56,30,86,2019-11-25,1,5
215,168,383,2019-11-25,1,6
474,391,865,2019-11-25,1,7
830,560,1390,2019-11-25,1,8
601,464,1065,2019-11-25,1,9
528,457,985,2019-11-25,1,10
522,508,1030,2019-11-25,1,11
474,529,1003,2019-11-25,1,12
468,569,1037,2019-11-25,1,13
489,594,1083,2019-11-25,1,14
501,562,1063,2019-11-25,1,15
606,646,1252,2019-11-25,1,16
658,710,1368,2019-11-25,1,17
496,566,1062,2019-11-25,1,18
328,471,799,2019-11-25,1,19
231,268,499,2019-11-25,1,20
140,147,287,2019-11-25,1,21
98,121,219,2019-11-25,1,22
48,61,109,2019-11-25,1,23
28,26,54,2019-11-25,1,24
12,11,23,2019-11-26,2,1
2,9,11,2019-11-26,2,2
8,10,18,2019-11-26,2,3
10,11,21,2019-11-26,2,4
37,35,72,2019-11-26,2,5
210,122,332,2019-11-26,2,6
517,415,932,2019-11-26,2,7
813,570,1383,2019-11-26,2,8
577,391,968,2019-11-26,2,9
490,457,947,2019-11-26,2,10
459,471,930,2019-11-26,2,11
506,480,986,2019-11-26,2,12
491,529,1020,2019-11-26,2,13
452,569,1021,2019-11-26,2,14
554,538,1092,2019-11-26,2,15
543,684,1227,2019-11-26,2,16
712,722,1434,2019-11-26,2,17
464,608,1072,2019-11-26,2,18
324,444,768,2019-11-26,2,19
242,240,482,2019-11-26,2,20
160,163,323,2019-11-26,2,21
99,126,225,2019-11-26,2,22
56,88,144,2019-11-26,2,23
30,32,62,2019-11-26,2,24
7,18,25,2019-11-27,3,1
7,14,21,2019-11-27,3,2
6,13,19,2019-11-27,3,3
7,16,23,2019-11-27,3,4
37,31,68,2019-11-27,3,5
196,137,333,2019-11-27,3,6
496,372,868,2019-11-27,3,7
787,550,1337,2019-11-27,3,8
528,412,940,2019-11-27,3,9
515,428,943,2019-11-27,3,10
497,454,951,2019-11-27,3,11
463,455,918,2019-11-27,3,12
466,540,1006,2019-11-27,3,13
480,595,1075,2019-11-27,3,14
542,575,1117,2019-11-27,3,15
552,697,1249,2019-11-27,3,16
667,697,1364,2019-11-27,3,17
474,547,1021,2019-11-27,3,18
322,418,740,2019-11-27,3,19
253,263,516,2019-11-27,3,20
149,176,325,2019-11-27,3,21
104,142,246,2019-11-27,3,22
58,72,130,2019-11-27,3,23
24,41,65,2019-11-27,3,24
20,12,32,2019-11-28,4,1
9,12,21,2019-11-28,4,2
6,9,15,2019-11-28,4,3
12,11,23,2019-11-28,4,4
33,36,69,2019-11-28,4,5
192,131,323,2019-11-28,4,6
514,388,902,2019-11-28,4,7
813,563,1376,2019-11-28,4,8
575,431,1006,2019-11-28,4,9
520,458,978,2019-11-28,4,10
459,479,938,2019-11-28,4,11
484,521,1005,2019-11-28,4,12
502,552,1054,2019-11-28,4,13
456,550,1006,2019-11-28,4,14
561,522,1083,2019-11-28,4,15
567,647,1214,2019-11-28,4,16
644,748,1392,2019-11-28,4,17
522,632,1154,2019-11-28,4,18
319,427,746,2019-11-28,4,19
274,287,561,2019-11-28,4,20
165,184,349,2019-11-28,4,21
102,139,241,2019-11-28,4,22
81,112,193,2019-11-28,4,23
27,38,65,2019-11-28,4,24
12,14,26,2019-11-29,5,1
8,8,16,2019-11-29,5,2
4,11,15,2019-11-29,5,3
7,15,22,2019-11-29,5,4
43,31,74,2019-11-29,5,5
184,132,316,2019-11-29,5,6
493,350,843,2019-11-29,5,7
744,494,1238,2019-11-29,5,8
534,435,969,2019-11-29,5,9
468,418,886,2019-11-29,5,10
532,483,1015,2019-11-29,5,11
596,585,1181,2019-11-29,5,12
562,607,1169,2019-11-29,5,13
668,688,1356,2019-11-29,5,14
641,656,1297,2019-11-29,5,15
620,589,1209,2019-11-29,5,16
568,589,1157,2019-11-29,5,17
410,457,867,2019-11-29,5,18
328,456,784,2019-11-29,5,19
219,246,465,2019-11-29,5,20
141,178,319,2019-11-29,5,21
116,144,260,2019-11-29,5,22
102,138,240,2019-11-29,5,23
56,83,139,2019-11-29,5,24
30,58,88,2019-11-30,6,1
30,31,61,2019-11-30,6,2
23,22,45,2019-11-30,6,3
16,24,40,2019-11-30,6,4
24,28,52,2019-11-30,6,5
75,50,125,2019-11-30,6,6
77,70,147,2019-11-30,6,7
138,90,228,2019-11-30,6,8
217,210,427,2019-11-30,6,9
360,287,647,2019-11-30,6,10
477,427,904,2019-11-30,6,11
514,490,1004,2019-11-30,6,12
458,507,965,2019-11-30,6,13
402,482,884,2019-11-30,6,14
422,427,849,2019-11-30,6,15
401,407,808,2019-11-30,6,16
343,412,755,2019-11-30,6,17
337,355,692,2019-11-30,6,18
245,290,535,2019-11-30,6,19
167,207,374,2019-11-30,6,20
118,187,305,2019-11-30,6,21
99,123,222,2019-11-30,6,22
101,97,198,2019-11-30,6,23
66,63,129,2019-11-30,6,24
45,36,81,2019-12-01,7,1
26,39,65,2019-12-01,7,2
17,27,44,2019-12-01,7,3
21,17,38,2019-12-01,7,4
19,40,59,2019-12-01,7,5
45,42,87,2019-12-01,7,6
33,48,81,2019-12-01,7,7
41,44,85,2019-12-01,7,8
116,83,199,2019-12-01,7,9
202,190,392,2019-12-01,7,10
278,334,612,2019-12-01,7,11
358,351,709,2019-12-01,7,12
441,384,825,2019-12-01,7,13
464,397,861,2019-12-01,7,14
469,462,931,2019-12-01,7,15
388,444,832,2019-12-01,7,16
379,368,747,2019-12-01,7,17
344,364,708,2019-12-01,7,18
198,286,484,2019-12-01,7,19
163,193,356,2019-12-01,7,20
130,139,269,2019-12-01,7,21
83,117,200,2019-12-01,7,22
37,59,96,2019-12-01,7,23
17,34,51,2019-12-01,7,24
8,28,36,2019-12-02,1,1
4,6,10,2019-12-02,1,2
8,10,18,2019-12-02,1,3
9,15,24,2019-12-02,1,4
53,48,101,2019-12-02,1,5
186,141,327,2019-12-02,1,6
548,403,951,2019-12-02,1,7
835,560,1395,2019-12-02,1,8
558,460,1018,2019-12-02,1,9
503,433,936,2019-12-02,1,10
505,475,980,2019-12-02,1,11
471,508,979,2019-12-02,1,12
460,527,987,2019-12-02,1,13
496,571,1067,2019-12-02,1,14
542,558,1100,2019-12-02,1,15
628,687,1315,2019-12-02,1,16
670,785,1455,2019-12-02,1,17
534,614,1148,2019-12-02,1,18
343,432,775,2019-12-02,1,19
222,282,504,2019-12-02,1,20
144,159,303,2019-12-02,1,21
99,136,235,2019-12-02,1,22
51,69,120,2019-12-02,1,23
24,28,52,2019-12-02,1,24
12,18,30,2019-12-03,2,1
8,9,17,2019-12-03,2,2
9,13,22,2019-12-03,2,3
10,6,16,2019-12-03,2,4
34,37,71,2019-12-03,2,5
207,145,352,2019-12-03,2,6
545,409,954,2019-12-03,2,7
794,545,1339,2019-12-03,2,8
570,463,1033,2019-12-03,2,9
539,429,968,2019-12-03,2,10
470,429,899,2019-12-03,2,11
481,512,993,2019-12-03,2,12
467,549,1016,2019-12-03,2,13
501,615,1116,2019-12-03,2,14
576,596,1172,2019-12-03,2,15
553,674,1227,2019-12-03,2,16
672,718,1390,2019-12-03,2,17
507,626,1133,2019-12-03,2,18
351,444,795,2019-12-03,2,19
225,279,504,2019-12-03,2,20
128,158,286,2019-12-03,2,21
108,116,224,2019-12-03,2,22
49,64,113,2019-12-03,2,23
29,24,53,2019-12-03,2,24
14,15,29,2019-12-04,3,1
9,11,20,2019-12-04,3,2
6,7,13,2019-12-04,3,3
8,10,18,2019-12-04,3,4
36,35,71,2019-12-04,3,5
196,152,348,2019-12-04,3,6
519,372,891,2019-12-04,3,7
772,533,1305,2019-12-04,3,8
553,448,1001,2019-12-04,3,9
491,397,888,2019-12-04,3,10
464,430,894,2019-12-04,3,11
470,481,951,2019-12-04,3,12
474,527,1001,2019-12-04,3,13
522,574,1096,2019-12-04,3,14
499,592,1091,2019-12-04,3,15
553,662,1215,2019-12-04,3,16
637,721,1358,2019-12-04,3,17
509,556,1065,2019-12-04,3,18
351,458,809,2019-12-04,3,19
204,242,446,2019-12-04,3,20
151,162,313,2019-12-04,3,21
124,147,271,2019-12-04,3,22
68,100,168,2019-12-04,3,23
26,32,58,2019-12-04,3,24
20,20,40,2019-12-05,4,1
8,11,19,2019-12-05,4,2
7,12,19,2019-12-05,4,3
13,13,26,2019-12-05,4,4
40,32,72,2019-12-05,4,5
179,132,311,2019-12-05,4,6
486,396,882,2019-12-05,4,7
825,554,1379,2019-12-05,4,8
581,397,978,2019-12-05,4,9
529,445,974,2019-12-05,4,10
492,486,978,2019-12-05,4,11
479,523,1002,2019-12-05,4,12
506,570,1076,2019-12-05,4,13
525,609,1134,2019-12-05,4,14
580,597,1177,2019-12-05,4,15
596,647,1243,2019-12-05,4,16
645,687,1332,2019-12-05,4,17
566,629,1195,2019-12-05,4,18
319,463,782,2019-12-05,4,19
234,284,518,2019-12-05,4,20
172,224,396,2019-12-05,4,21
110,167,277,2019-12-05,4,22
71,84,155,2019-12-05,4,23
32,34,66,2019-12-05,4,24
23,31,54,2019-12-06,5,1
12,11,23,2019-12-06,5,2
8,6,14,2019-12-06,5,3
10,18,28,2019-12-06,5,4
39,35,74,2019-12-06,5,5
182,136,318,2019-12-06,5,6
451,354,805,2019-12-06,5,7
754,518,1272,2019-12-06,5,8
555,430,985,2019-12-06,5,9
470,485,955,2019-12-06,5,10
479,455,934,2019-12-06,5,11
560,565,1125,2019-12-06,5,12
577,611,1188,2019-12-06,5,13
553,647,1200,2019-12-06,5,14
574,652,1226,2019-12-06,5,15
520,614,1134,2019-12-06,5,16
557,512,1069,2019-12-06,5,17
423,425,848,2019-12-06,5,18
373,396,769,2019-12-06,5,19
274,251,525,2019-12-06,5,20
155,183,338,2019-12-06,5,21
115,148,263,2019-12-06,5,22
103,166,269,2019-12-06,5,23
67,103,170,2019-12-06,5,24
44,61,105,2019-12-07,6,1
20,20,40,2019-12-07,6,2
22,30,52,2019-12-07,6,3
15,18,33,2019-12-07,6,4
20,19,39,2019-12-07,6,5
64,47,111,2019-12-07,6,6
81,65,146,2019-12-07,6,7
127,95,222,2019-12-07,6,8
293,191,484,2019-12-07,6,9
349,281,630,2019-12-07,6,10
439,423,862,2019-12-07,6,11
532,452,984,2019-12-07,6,12
488,599,1087,2019-12-07,6,13
474,530,1004,2019-12-07,6,14
373,485,858,2019-12-07,6,15
408,446,854,2019-12-07,6,16
382,400,782,2019-12-07,6,17
382,351,733,2019-12-07,6,18
294,311,605,2019-12-07,6,19
185,209,394,2019-12-07,6,20
115,156,271,2019-12-07,6,21
104,127,231,2019-12-07,6,22
75,91,166,2019-12-07,6,23
73,71,144,2019-12-07,6,24
44,61,105,2019-12-08,7,1
42,55,97,2019-12-08,7,2
22,25,47,2019-12-08,7,3
14,23,37,2019-12-08,7,4
16,14,30,2019-12-08,7,5
45,48,93,2019-12-08,7,6
40,47,87,2019-12-08,7,7
45,37,82,2019-12-08,7,8
76,76,152,2019-12-08,7,9
178,178,356,2019-12-08,7,10
210,272,482,2019-12-08,7,11
269,324,593,2019-12-08,7,12
339,312,651,2019-12-08,7,13
349,366,715,2019-12-08,7,14
390,416,806,2019-12-08,7,15
353,370,723,2019-12-08,7,16
336,295,631,2019-12-08,7,17
290,287,577,2019-12-08,7,18
226,282,508,2019-12-08,7,19
173,202,375,2019-12-08,7,20
110,137,247,2019-12-08,7,21
81,101,182,2019-12-08,7,22
56,56,112,2019-12-08,7,23
19,30,49,2019-12-08,7,24
10,25,35,2019-12-09,1,1
7,4,11,2019-12-09,1,2
7,6,13,2019-12-09,1,3
5,17,22,2019-12-09,1,4
52,39,91,2019-12-09,1,5
192,148,340,2019-12-09,1,6
543,408,951,2019-12-09,1,7
809,544,1353,2019-12-09,1,8
577,442,1019,2019-12-09,1,9
504,394,898,2019-12-09,1,10
530,470,1000,2019-12-09,1,11
491,488,979,2019-12-09,1,12
462,561,1023,2019-12-09,1,13
484,557,1041,2019-12-09,1,14
585,587,1172,2019-12-09,1,15
551,603,1154,2019-12-09,1,16
703,759,1462,2019-12-09,1,17
496,594,1090,2019-12-09,1,18
339,465,804,2019-12-09,1,19
215,290,505,2019-12-09,1,20
139,159,298,2019-12-09,1,21
84,108,192,2019-12-09,1,22
49,62,111,2019-12-09,1,23
27,22,49,2019-12-09,1,24
11,14,25,2019-12-10,2,1
5,9,14,2019-12-10,2,2
8,8,16,2019-12-10,2,3
14,9,23,2019-12-10,2,4
36,33,69,2019-12-10,2,5
188,150,338,2019-12-10,2,6
502,365,867,2019-12-10,2,7
826,532,1358,2019-12-10,2,8
544,422,966,2019-12-10,2,9
474,437,911,2019-12-10,2,10
511,486,997,2019-12-10,2,11
476,460,936,2019-12-10,2,12
490,507,997,2019-12-10,2,13
499,596,1095,2019-12-10,2,14
587,623,1210,2019-12-10,2,15
596,650,1246,2019-12-10,2,16
666,644,1310,2019-12-10,2,17
489,627,1116,2019-12-10,2,18
354,441,795,2019-12-10,2,19
217,254,471,2019-12-10,2,20
139,196,335,2019-12-10,2,21
118,108,226,2019-12-10,2,22
90,92,182,2019-12-10,2,23
32,29,61,2019-12-10,2,24
14,21,35,2019-12-11,3,1
4,6,10,2019-12-11,3,2
9,6,15,2019-12-11,3,3
7,9,16,2019-12-11,3,4
30,39,69,2019-12-11,3,5
196,131,327,2019-12-11,3,6
506,339,845,2019-12-11,3,7
796,545,1341,2019-12-11,3,8
568,393,961,2019-12-11,3,9
498,409,907,2019-12-11,3,10
455,467,922,2019-12-11,3,11
507,477,984,2019-12-11,3,12
467,523,990,2019-12-11,3,13
471,569,1040,2019-12-11,3,14
447,567,1014,2019-12-11,3,15
543,626,1169,2019-12-11,3,16
609,692,1301,2019-12-11,3,17
483,588,1071,2019-12-11,3,18
355,471,826,2019-12-11,3,19
234,249,483,2019-12-11,3,20
146,194,340,2019-12-11,3,21
111,148,259,2019-12-11,3,22
61,91,152,2019-12-11,3,23
29,36,65,2019-12-11,3,24
25,30,55,2019-12-12,4,1
11,22,33,2019-12-12,4,2
11,12,23,2019-12-12,4,3
10,9,19,2019-12-12,4,4
38,42,80,2019-12-12,4,5
166,120,286,2019-12-12,4,6
505,374,879,2019-12-12,4,7
825,547,1372,2019-12-12,4,8
571,424,995,2019-12-12,4,9
547,421,968,2019-12-12,4,10
515,463,978,2019-12-12,4,11
502,521,1023,2019-12-12,4,12
475,554,1029,2019-12-12,4,13
466,625,1091,2019-12-12,4,14
497,552,1049,2019-12-12,4,15
631,643,1274,2019-12-12,4,16
716,727,1443,2019-12-12,4,17
525,632,1157,2019-12-12,4,18
329,495,824,2019-12-12,4,19
233,305,538,2019-12-12,4,20
129,228,357,2019-12-12,4,21
122,181,303,2019-12-12,4,22
109,113,222,2019-12-12,4,23
48,47,95,2019-12-12,4,24
28,19,47,2019-12-13,5,1
14,12,26,2019-12-13,5,2
7,11,18,2019-12-13,5,3
14,19,33,2019-12-13,5,4
40,35,75,2019-12-13,5,5
164,118,282,2019-12-13,5,6
472,275,747,2019-12-13,5,7
719,479,1198,2019-12-13,5,8
551,418,969,2019-12-13,5,9
463,423,886,2019-12-13,5,10
491,470,961,2019-12-13,5,11
475,543,1018,2019-12-13,5,12
567,667,1234,2019-12-13,5,13
628,706,1334,2019-12-13,5,14
593,701,1294,2019-12-13,5,15
507,645,1152,2019-12-13,5,16
547,574,1121,2019-12-13,5,17
459,495,954,2019-12-13,5,18
384,422,806,2019-12-13,5,19
250,233,483,2019-12-13,5,20
138,170,308,2019-12-13,5,21
96,165,261,2019-12-13,5,22
101,133,234,2019-12-13,5,23
77,115,192,2019-12-13,5,24
54,78,132,2019-12-14,6,1
39,33,72,2019-12-14,6,2
23,30,53,2019-12-14,6,3
25,24,49,2019-12-14,6,4
39,34,73,2019-12-14,6,5
64,48,112,2019-12-14,6,6
70,59,129,2019-12-14,6,7
115,93,208,2019-12-14,6,8
235,155,390,2019-12-14,6,9
311,265,576,2019-12-14,6,10
442,375,817,2019-12-14,6,11
455,461,916,2019-12-14,6,12
421,402,823,2019-12-14,6,13
385,421,806,2019-12-14,6,14
360,396,756,2019-12-14,6,15
321,398,719,2019-12-14,6,16
306,367,673,2019-12-14,6,17
345,312,657,2019-12-14,6,18
294,280,574,2019-12-14,6,19
175,218,393,2019-12-14,6,20
130,132,262,2019-12-14,6,21
68,105,173,2019-12-14,6,22
75,91,166,2019-12-14,6,23
68,71,139,2019-12-14,6,24
51,50,101,2019-12-15,7,1
39,41,80,2019-12-15,7,2
27,19,46,2019-12-15,7,3
14,18,32,2019-12-15,7,4
15,18,33,2019-12-15,7,5
48,35,83,2019-12-15,7,6
34,30,64,2019-12-15,7,7
32,43,75,2019-12-15,7,8
83,61,144,2019-12-15,7,9
160,162,322,2019-12-15,7,10
226,227,453,2019-12-15,7,11
283,316,599,2019-12-15,7,12
369,304,673,2019-12-15,7,13
337,306,643,2019-12-15,7,14
430,408,838,2019-12-15,7,15
433,374,807,2019-12-15,7,16
329,354,683,2019-12-15,7,17
320,285,605,2019-12-15,7,18
197,219,416,2019-12-15,7,19
148,190,338,2019-12-15,7,20
109,156,265,2019-12-15,7,21
65,83,148,2019-12-15,7,22
46,50,96,2019-12-15,7,23
16,26,42,2019-12-15,7,24
9,17,26,2019-12-16,1,1
6,8,14,2019-12-16,1,2
9,9,18,2019-12-16,1,3
7,11,18,2019-12-16,1,4
42,34,76,2019-12-16,1,5
177,137,314,2019-12-16,1,6
511,383,894,2019-12-16,1,7
787,530,1317,2019-12-16,1,8
566,420,986,2019-12-16,1,9
518,437,955,2019-12-16,1,10
522,494,1016,2019-12-16,1,11
501,548,1049,2019-12-16,1,12
466,536,1002,2019-12-16,1,13
507,567,1074,2019-12-16,1,14
504,500,1004,2019-12-16,1,15
603,658,1261,2019-12-16,1,16
675,713,1388,2019-12-16,1,17
472,611,1083,2019-12-16,1,18
334,465,799,2019-12-16,1,19
221,275,496,2019-12-16,1,20
150,153,303,2019-12-16,1,21
85,96,181,2019-12-16,1,22
44,87,131,2019-12-16,1,23
33,37,70,2019-12-16,1,24
6,22,28,2019-12-17,2,1
6,9,15,2019-12-17,2,2
12,10,22,2019-12-17,2,3
12,14,26,2019-12-17,2,4
29,31,60,2019-12-17,2,5
180,126,306,2019-12-17,2,6
493,365,858,2019-12-17,2,7
727,512,1239,2019-12-17,2,8
569,387,956,2019-12-17,2,9
491,438,929,2019-12-17,2,10
504,462,966,2019-12-17,2,11
497,488,985,2019-12-17,2,12
447,557,1004,2019-12-17,2,13
509,620,1129,2019-12-17,2,14
629,540,1169,2019-12-17,2,15
560,673,1233,2019-12-17,2,16
660,721,1381,2019-12-17,2,17
495,638,1133,2019-12-17,2,18
339,470,809,2019-12-17,2,19
214,270,484,2019-12-17,2,20
121,183,304,2019-12-17,2,21
101,132,233,2019-12-17,2,22
62,81,143,2019-12-17,2,23
34,58,92,2019-12-17,2,24
15,15,30,2019-12-18,3,1
9,10,19,2019-12-18,3,2
11,7,18,2019-12-18,3,3
10,13,23,2019-12-18,3,4
37,39,76,2019-12-18,3,5
185,123,308,2019-12-18,3,6
466,324,790,2019-12-18,3,7
768,530,1298,2019-12-18,3,8
568,402,970,2019-12-18,3,9
544,456,1000,2019-12-18,3,10
527,492,1019,2019-12-18,3,11
548,568,1116,2019-12-18,3,12
515,571,1086,2019-12-18,3,13
486,576,1062,2019-12-18,3,14
511,663,1174,2019-12-18,3,15
574,687,1261,2019-12-18,3,16
657,717,1374,2019-12-18,3,17
465,538,1003,2019-12-18,3,18
338,487,825,2019-12-18,3,19
233,240,473,2019-12-18,3,20
138,191,329,2019-12-18,3,21
107,151,258,2019-12-18,3,22
79,73,152,2019-12-18,3,23
38,47,85,2019-12-18,3,24
23,25,48,2019-12-19,4,1
8,10,18,2019-12-19,4,2
6,7,13,2019-12-19,4,3
11,11,22,2019-12-19,4,4
39,38,77,2019-12-19,4,5
166,112,278,2019-12-19,4,6
428,318,746,2019-12-19,4,7
740,490,1230,2019-12-19,4,8
529,409,938,2019-12-19,4,9
527,439,966,2019-12-19,4,10
515,495,1010,2019-12-19,4,11
493,522,1015,2019-12-19,4,12
502,549,1051,2019-12-19,4,13
522,596,1118,2019-12-19,4,14
546,570,1116,2019-12-19,4,15
624,623,1247,2019-12-19,4,16
603,684,1287,2019-12-19,4,17
490,576,1066,2019-12-19,4,18
334,461,795,2019-12-19,4,19
249,307,556,2019-12-19,4,20
156,210,366,2019-12-19,4,21
126,145,271,2019-12-19,4,22
86,119,205,2019-12-19,4,23
50,65,115,2019-12-19,4,24
13,23,36,2019-12-20,5,1
14,19,33,2019-12-20,5,2
24,19,43,2019-12-20,5,3
28,22,50,2019-12-20,5,4
42,43,85,2019-12-20,5,5
151,97,248,2019-12-20,5,6
361,274,635,2019-12-20,5,7
677,464,1141,2019-12-20,5,8
475,387,862,2019-12-20,5,9
538,421,959,2019-12-20,5,10
582,503,1085,2019-12-20,5,11
553,621,1174,2019-12-20,5,12
602,686,1288,2019-12-20,5,13
543,637,1180,2019-12-20,5,14
564,621,1185,2019-12-20,5,15
557,554,1111,2019-12-20,5,16
513,523,1036,2019-12-20,5,17
479,522,1001,2019-12-20,5,18
289,396,685,2019-12-20,5,19
217,247,464,2019-12-20,5,20
130,177,307,2019-12-20,5,21
92,135,227,2019-12-20,5,22
73,120,193,2019-12-20,5,23
87,73,160,2019-12-20,5,24
41,47,88,2019-12-21,6,1
23,26,49,2019-12-21,6,2
7,17,24,2019-12-21,6,3
15,14,29,2019-12-21,6,4
22,26,48,2019-12-21,6,5
69,53,122,2019-12-21,6,6
64,53,117,2019-12-21,6,7
121,81,202,2019-12-21,6,8
226,195,421,2019-12-21,6,9
333,269,602,2019-12-21,6,10
496,408,904,2019-12-21,6,11
469,459,928,2019-12-21,6,12
426,449,875,2019-12-21,6,13
378,483,861,2019-12-21,6,14
397,387,784,2019-12-21,6,15
354,411,765,2019-12-21,6,16
334,356,690,2019-12-21,6,17
318,295,613,2019-12-21,6,18
207,296,503,2019-12-21,6,19
158,196,354,2019-12-21,6,20
108,146,254,2019-12-21,6,21
79,115,194,2019-12-21,6,22
57,74,131,2019-12-21,6,23
50,60,110,2019-12-21,6,24
34,41,75,2019-12-22,7,1
38,31,69,2019-12-22,7,2
16,26,42,2019-12-22,7,3
21,19,40,2019-12-22,7,4
10,12,22,2019-12-22,7,5
43,29,72,2019-12-22,7,6
30,47,77,2019-12-22,7,7
34,42,76,2019-12-22,7,8
64,62,126,2019-12-22,7,9
165,153,318,2019-12-22,7,10
221,213,434,2019-12-22,7,11
354,236,590,2019-12-22,7,12
412,282,694,2019-12-22,7,13
390,381,771,2019-12-22,7,14
429,446,875,2019-12-22,7,15
343,372,715,2019-12-22,7,16
301,450,751,2019-12-22,7,17
303,371,674,2019-12-22,7,18
185,269,454,2019-12-22,7,19
154,192,346,2019-12-22,7,20
106,134,240,2019-12-22,7,21
64,107,171,2019-12-22,7,22
51,59,110,2019-12-22,7,23
31,42,73,2019-12-22,7,24
19,29,48,2019-12-23,1,1
11,10,21,2019-12-23,1,2
10,14,24,2019-12-23,1,3
13,12,25,2019-12-23,1,4
27,25,52,2019-12-23,1,5
82,64,146,2019-12-23,1,6
199,125,324,2019-12-23,1,7
309,214,523,2019-12-23,1,8
394,297,691,2019-12-23,1,9
477,402,879,2019-12-23,1,10
547,471,1018,2019-12-23,1,11
542,529,1071,2019-12-23,1,12
548,507,1055,2019-12-23,1,13
440,505,945,2019-12-23,1,14
497,517,1014,2019-12-23,1,15
462,524,986,2019-12-23,1,16
435,471,906,2019-12-23,1,17
313,394,707,2019-12-23,1,18
259,352,611,2019-12-23,1,19
174,216,390,2019-12-23,1,20
130,147,277,2019-12-23,1,21
92,114,206,2019-12-23,1,22
46,79,125,2019-12-23,1,23
47,52,99,2019-12-23,1,24
19,28,47,2019-12-24,2,1
11,19,30,2019-12-24,2,2
16,17,33,2019-12-24,2,3
17,14,31,2019-12-24,2,4
20,18,38,2019-12-24,2,5
69,40,109,2019-12-24,2,6
59,68,127,2019-12-24,2,7
135,82,217,2019-12-24,2,8
193,140,333,2019-12-24,2,9
280,239,519,2019-12-24,2,10
350,318,668,2019-12-24,2,11
301,345,646,2019-12-24,2,12
286,379,665,2019-12-24,2,13
277,359,636,2019-12-24,2,14
279,331,610,2019-12-24,2,15
275,305,580,2019-12-24,2,16
271,244,515,2019-12-24,2,17
185,187,372,2019-12-24,2,18
104,86,190,2019-12-24,2,19
67,93,160,2019-12-24,2,20
103,100,203,2019-12-24,2,21
126,126,252,2019-12-24,2,22
156,151,307,2019-12-24,2,23
118,109,227,2019-12-24,2,24
65,68,133,2019-12-25,3,1
24,36,60,2019-12-25,3,2
12,16,28,2019-12-25,3,3
8,9,17,2019-12-25,3,4
12,12,24,2019-12-25,3,5
39,34,73,2019-12-25,3,6
31,31,62,2019-12-25,3,7
22,26,48,2019-12-25,3,8
49,53,102,2019-12-25,3,9
117,107,224,2019-12-25,3,10
202,212,414,2019-12-25,3,11
274,305,579,2019-12-25,3,12
274,291,565,2019-12-25,3,13
297,295,592,2019-12-25,3,14
352,343,695,2019-12-25,3,15
288,301,589,2019-12-25,3,16
282,282,564,2019-12-25,3,17
257,270,527,2019-12-25,3,18
206,197,403,2019-12-25,3,19
170,166,336,2019-12-25,3,20
145,150,295,2019-12-25,3,21
114,129,243,2019-12-25,3,22
74,84,158,2019-12-25,3,23
47,57,104,2019-12-25,3,24
27,30,57,2019-12-26,4,1
15,26,41,2019-12-26,4,2
24,26,50,2019-12-26,4,3
20,27,47,2019-12-26,4,4
19,21,40,2019-12-26,4,5
41,41,82,2019-12-26,4,6
33,30,63,2019-12-26,4,7
31,33,64,2019-12-26,4,8
58,54,112,2019-12-26,4,9
137,130,267,2019-12-26,4,10
221,229,450,2019-12-26,4,11
325,348,673,2019-12-26,4,12
362,349,711,2019-12-26,4,13
385,369,754,2019-12-26,4,14
408,433,841,2019-12-26,4,15
316,349,665,2019-12-26,4,16
290,285,575,2019-12-26,4,17
296,249,545,2019-12-26,4,18
218,215,433,2019-12-26,4,19
177,177,354,2019-12-26,4,20
147,171,318,2019-12-26,4,21
118,116,234,2019-12-26,4,22
60,59,119,2019-12-26,4,23
32,47,79,2019-12-26,4,24
21,30,51,2019-12-27,5,1
15,17,32,2019-12-27,5,2
3,12,15,2019-12-27,5,3
13,25,38,2019-12-27,5,4
33,30,63,2019-12-27,5,5
86,71,157,2019-12-27,5,6
132,102,234,2019-12-27,5,7
220,167,387,2019-12-27,5,8
263,222,485,2019-12-27,5,9
374,306,680,2019-12-27,5,10
495,407,902,2019-12-27,5,11
494,429,923,2019-12-27,5,12
455,435,890,2019-12-27,5,13
481,493,974,2019-12-27,5,14
479,491,970,2019-12-27,5,15
431,422,853,2019-12-27,5,16
327,412,739,2019-12-27,5,17
291,334,625,2019-12-27,5,18
249,316,565,2019-12-27,5,19
173,201,374,2019-12-27,5,20
133,156,289,2019-12-27,5,21
70,94,164,2019-12-27,5,22
66,94,160,2019-12-27,5,23
54,58,112,2019-12-27,5,24
21,35,56,2019-12-28,6,1
23,23,46,2019-12-28,6,2
9,11,20,2019-12-28,6,3
11,17,28,2019-12-28,6,4
27,27,54,2019-12-28,6,5
58,46,104,2019-12-28,6,6
55,51,106,2019-12-28,6,7
80,67,147,2019-12-28,6,8
190,129,319,2019-12-28,6,9
261,228,489,2019-12-28,6,10
408,341,749,2019-12-28,6,11
490,438,928,2019-12-28,6,12
475,511,986,2019-12-28,6,13
432,558,990,2019-12-28,6,14
385,560,945,2019-12-28,6,15
321,467,788,2019-12-28,6,16
345,392,737,2019-12-28,6,17
258,313,571,2019-12-28,6,18
184,232,416,2019-12-28,6,19
178,165,343,2019-12-28,6,20
108,157,265,2019-12-28,6,21
78,99,177,2019-12-28,6,22
66,97,163,2019-12-28,6,23
40,78,118,2019-12-28,6,24
39,39,78,2019-12-29,7,1
32,35,67,2019-12-29,7,2
20,15,35,2019-12-29,7,3
14,22,36,2019-12-29,7,4
19,12,31,2019-12-29,7,5
41,36,77,2019-12-29,7,6
28,40,68,2019-12-29,7,7
33,44,77,2019-12-29,7,8
67,57,124,2019-12-29,7,9
155,152,307,2019-12-29,7,10
231,221,452,2019-12-29,7,11
390,306,696,2019-12-29,7,12
441,357,798,2019-12-29,7,13
455,387,842,2019-12-29,7,14
446,404,850,2019-12-29,7,15
374,467,841,2019-12-29,7,16
268,411,679,2019-12-29,7,17
229,328,557,2019-12-29,7,18
186,222,408,2019-12-29,7,19
137,141,278,2019-12-29,7,20
97,128,225,2019-12-29,7,21
59,87,146,2019-12-29,7,22
52,57,109,2019-12-29,7,23
31,41,72,2019-12-29,7,24
20,31,51,2019-12-30,1,1
18,15,33,2019-12-30,1,2
7,10,17,2019-12-30,1,3
12,15,27,2019-12-30,1,4
18,18,36,2019-12-30,1,5
88,67,155,2019-12-30,1,6
147,119,266,2019-12-30,1,7
249,171,420,2019-12-30,1,8
278,205,483,2019-12-30,1,9
404,330,734,2019-12-30,1,10
502,433,935,2019-12-30,1,11
514,463,977,2019-12-30,1,12
488,473,961,2019-12-30,1,13
514,507,1021,2019-12-30,1,14
550,486,1036,2019-12-30,1,15
424,507,931,2019-12-30,1,16
410,470,880,2019-12-30,1,17
311,409,720,2019-12-30,1,18
251,339,590,2019-12-30,1,19
194,226,420,2019-12-30,1,20
130,159,289,2019-12-30,1,21
96,98,194,2019-12-30,1,22
76,66,142,2019-12-30,1,23
52,34,86,2019-12-30,1,24
35,74,109,2019-12-31,2,1
13,26,39,2019-12-31,2,2
11,16,27,2019-12-31,2,3
14,21,35,2019-12-31,2,4
26,24,50,2019-12-31,2,5
52,51,103,2019-12-31,2,6
73,68,141,2019-12-31,2,7
132,100,232,2019-12-31,2,8
200,141,341,2019-12-31,2,9
249,211,460,2019-12-31,2,10
356,290,646,2019-12-31,2,11
416,347,763,2019-12-31,2,12
300,333,633,2019-12-31,2,13
287,431,718,2019-12-31,2,14
330,394,724,2019-12-31,2,15
266,314,580,2019-12-31,2,16
251,261,512,2019-12-31,2,17
223,237,460,2019-12-31,2,18
181,175,356,2019-12-31,2,19
133,136,269,2019-12-31,2,20
97,93,190,2019-12-31,2,21
69,73,142,2019-12-31,2,22
60,37,97,2019-12-31,2,23
64,38,102,2019-12-31,2,24
